Room No. 1 , Exit D, 
 dX[m], dY[m] , minX[m] , maxX[m], minY[m], maxY[m] 
   1.000000  ,  1.000000    ,  -5.000000  ,  11.000000  ,  -11.000000 ,  37.000000
8.682796976175035297e+01,5.638998812098819968e+01,8.140645963894552040e+01,1.334396733443773826e+02,2.812562316723804656e+02,4.861009017970045676e+01,4.644349074662173393e+01,4.684954453706071575e+01,4.722083969094614986e+01,4.755388475791144032e+01,4.751792147524026433e+01,4.713289591082590135e+01,4.672524812565755070e+01,4.667602720252830295e+01,4.637986034206753772e+01,4.619284612336303297e+01
9.632825780601504562e+01,5.589077373365508805e+01,8.087333323996735146e+01,1.326468902451210852e+02,2.852482437390725067e+02,4.989331743836864064e+01,4.766044144219559087e+01,4.811292555613692912e+01,4.854270594658431293e+01,4.881609116575342000e+01,4.873637138902809340e+01,4.827127625691182544e+01,4.794346800489739024e+01,4.780836945222987566e+01,4.755782267431476384e+01,4.728193854478217872e+01
1.111413153949002606e+02,5.637114836793830364e+01,8.029432240807261678e+01,1.318081586928915954e+02,2.886021118544335309e+02,5.124768222667682238e+01,4.894889672224321941e+01,4.943232260594655259e+01,4.994992233851393593e+01,5.014693655330955124e+01,5.001882025388654540e+01,4.953201096942731851e+01,4.920732779704476201e+01,4.898631984435341025e+01,4.873858881830975065e+01,4.838662371524602435e+01
1.187311973334868611e+02,5.827526102042699563e+01,7.963590083912720274e+01,1.309081763031325067e+02,2.906379034550885763e+02,5.267921697855991425e+01,5.031499290506059907e+01,5.081168242506021215e+01,5.143263408282504656e+01,5.155868588824019838e+01,5.141204297162974513e+01,5.086105315460641663e+01,5.056930176410001820e+01,5.029726162255105493e+01,5.002849052700773314e+01,4.959457872299299197e+01
1.200923298542896163e+02,6.002017082134303649e+01,7.886943999540251582e+01,1.299661259953425940e+02,2.910197742349822647e+02,5.419471058106597638e+01,5.176539816327657917e+01,5.225981831605536598e+01,5.297610195442597103e+01,5.305666773426160887e+01,5.289378060095453549e+01,5.221758043806880067e+01,5.205964708306223798e+01,5.170260186116482259e+01,5.148181119035611175e+01,5.082166487661739751e+01
1.218880961447042495e+02,6.113702091025419350e+01,7.795881763176838319e+01,1.290109065653713571e+02,2.898505526441966254e+02,5.580177232755053041e+01,5.330773340260638093e+01,5.379230805372030488e+01,5.456859034132164510e+01,5.462355479689507121e+01,5.435820412062975038e+01,5.365548418745645165e+01,5.355104910207096935e+01,5.319708212841287320e+01,5.280228344899193615e+01,5.216097097275236649e+01
1.232561369050366835e+02,6.286022232710870128e+01,7.673549666274929848e+01,1.280402418167842313e+02,2.877042689757517451e+02,5.750895966572939244e+01,5.494989741129086269e+01,5.543040334730953589e+01,5.622529455749057092e+01,5.625973718673766655e+01,5.582163306399105807e+01,5.526162194183058318e+01,5.503683412745179027e+01,5.468738628375758282e+01,5.422652014987732372e+01,5.354899019820134498e+01
1.240911172620163114e+02,6.479630925141485420e+01,7.528429418588385147e+01,1.270162755365883100e+02,2.854855352020507553e+02,5.932593062510415649e+01,5.670047108424607529e+01,5.719725670034429754e+01,5.798786729672838902e+01,5.800438673231247577e+01,5.740994011717221213e+01,5.696553136388131833e+01,5.666201918525011649e+01,5.634130950204159660e+01,5.572860224106402427e+01,5.501946795442317750e+01
1.244927805660493902e+02,6.698660879220732056e+01,7.402714910959115002e+01,1.258851133502682842e+02,2.838452191310238391e+02,6.126362662639625967e+01,5.856854351080939125e+01,5.911505005187982675e+01,5.989280661675049799e+01,5.986237260143641947e+01,5.920674822426149575e+01,5.880361370325387327e+01,5.844557969109360585e+01,5.815348095705095233e+01,5.731665190440769209e+01,5.704035730076169131e+01
1.244210763732007763e+02,6.944439147131662082e+01,7.323373377964860254e+01,1.247870045378204225e+02,2.828579889478627933e+02,6.333449298076090628e+01,6.056389090012610410e+01,6.118998412717282775e+01,6.194171154455327155e+01,6.182028762080291528e+01,6.112179513171809475e+01,6.083415476395136778e+01,6.038862403523945233e+01,5.983159427386055995e+01,5.903241400812390793e+01,5.915774951902380963e+01
1.240087263505517541e+02,7.211688547991980158e+01,7.317793276622315091e+01,1.235520905639126426e+02,2.821156356829893070e+02,6.555275942618700924e+01,6.269982108055377523e+01,6.342070100108487196e+01,6.412770001074277104e+01,6.396996758196542743e+01,6.309566830360186174e+01,6.285256590025343115e+01,6.233029410328262543e+01,6.170111735181450285e+01,6.078424479852788664e+01,6.114735571630122024e+01
1.234329872966247450e+02,7.492835395972561230e+01,7.403630965781751172e+01,1.222083604005541559e+02,2.811282393436210896e+02,5.672852098054310233e+01,5.379146504521999361e+01,5.461979601313541366e+01,5.527782110694047191e+01,5.508752524114129301e+01,5.409250301237120340e+01,5.374656401711969522e+01,5.333824318104701234e+01,5.245822308089149999e+01,5.206928474170723575e+01,5.495294419283936094e+01
1.228582757417932072e+02,7.742307985821439331e+01,7.598974812580813420e+01,1.208345552003601284e+02,2.795907203154208105e+02,5.607256110290638418e+01,5.324597072241419227e+01,5.432001646601709410e+01,5.499341057174370917e+01,5.465161556082085070e+01,5.389063815988610884e+01,5.357722302752098642e+01,5.314514473202987688e+01,5.224086689684546059e+01,5.240216442165617394e+01,5.515357387651501853e+01
1.224256168243599774e+02,7.900729275858316214e+01,7.850975031896282985e+01,1.193882542157032844e+02,2.774866311454754282e+02,5.626957964418108560e+01,5.322482602106372696e+01,5.429670038950720823e+01,5.504347194950660338e+01,5.486658229663332520e+01,5.414230465154353311e+01,5.374641135692064609e+01,5.316451157159637120e+01,5.224041938699996734e+01,5.281992528278838250e+01,5.528705652904704948e+01
1.221315255411211922e+02,7.975745499030321639e+01,8.173931400370648248e+01,1.176910710490360543e+02,2.753746416762406284e+02,5.744423283570544214e+01,5.430436651992258135e+01,5.521194983248287969e+01,5.562171361229482613e+01,5.528698287599543448e+01,5.471149176142616710e+01,5.425387945941939449e+01,5.351059837664405450e+01,5.316172032332486452e+01,5.359084208378372693e+01,5.557979033368397381e+01
1.217997782392302497e+02,7.959536813021315993e+01,8.536441067381194614e+01,1.151408294628680835e+02,2.732844774960262839e+02,5.826470404186417795e+01,5.583641296344833194e+01,5.627812567350483874e+01,5.648142451139325715e+01,5.591027668130633543e+01,5.550539044273516964e+01,5.484084108050349471e+01,5.400002856581179600e+01,5.406483518029217095e+01,5.407371827267082409e+01,5.568831538319922458e+01
1.214774855530113200e+02,7.884856378359620521e+01,8.934303173448050472e+01,1.124381566545040556e+02,2.711583780413005798e+02,5.913563910999233286e+01,5.711327190491958561e+01,5.743371881950108104e+01,5.746922054151704629e+01,5.658900486810782127e+01,5.621567515829111272e+01,5.547700513581846593e+01,5.490811286183452467e+01,5.512014075587116935e+01,5.460898788213287958e+01,5.634158729153983813e+01
1.211946760629759154e+02,7.797107269933070484e+01,9.383928821641204365e+01,1.093737937776659237e+02,2.687658754033881223e+02,6.029194215123862932e+01,5.839652430406592032e+01,5.871662238392749344e+01,5.855368891142648380e+01,5.770371669074494747e+01,5.704265547373931611e+01,5.628988530256274458e+01,5.601638355601284758e+01,5.616479846309956514e+01,5.534198771774795489e+01,5.710891775683506921e+01
1.208294699791614164e+02,7.727667120801957878e+01,9.842792729971564825e+01,1.064888267326050766e+02,2.660051502801270544e+02,6.171768121191369261e+01,5.992618664944872364e+01,6.009737522579219160e+01,6.003667044022724752e+01,5.902396186950451096e+01,5.824540631915127875e+01,5.739715478874582999e+01,5.726363237604822132e+01,5.727162162926533284e+01,5.654522311709011007e+01,5.819942270678759400e+01
1.205378030670787268e+02,7.683227477207108791e+01,1.023235952266429081e+02,1.049855868273077562e+02,2.627169354634104934e+02,6.355657520125202353e+01,6.167608215743812394e+01,6.172511409298546425e+01,6.167868753040764318e+01,6.067317818578472810e+01,5.972456558047163355e+01,5.878589126143577914e+01,5.905368914059000218e+01,5.846633188245608181e+01,5.816526419897798661e+01,6.031531923287787578e+01
1.201666234343269366e+02,7.636843643412792915e+01,1.043802730778643166e+02,1.064225227532424327e+02,2.591130660545015303e+02,6.567067414609373088e+01,6.382338340818372302e+01,6.367074052929917372e+01,6.346624306897855661e+01,6.244212221608103874e+01,6.145328175372216606e+01,6.089488099475005356e+01,6.102633068200157140e+01,6.059485856868055009e+01,6.040035038264453959e+01,6.287641932088571650e+01
1.197612580398646855e+02,7.595961091712993607e+01,1.042717930269107853e+02,1.118263837538782184e+02,2.551932492683505131e+02,6.810291729207293088e+01,6.637810837889111326e+01,6.624237548715782964e+01,6.558505830778430834e+01,6.464520615365441358e+01,6.374459015463786216e+01,6.346499093397786595e+01,6.317628880687576043e+01,6.306251980992821160e+01,6.287679194050062392e+01,6.562735438951573030e+01
1.193924189756868799e+02,7.543358200701894134e+01,1.031005568030803943e+02,1.199287739016343863e+02,2.509452525139016075e+02,7.090840429242568632e+01,6.945894219795680158e+01,6.932377722032953216e+01,6.815325620536246731e+01,6.738335850310053843e+01,6.640325677278123351e+01,6.641725098173354525e+01,6.597474166450614064e+01,6.577293939237760867e+01,6.576326671427334247e+01,6.840435737224538570e+01
1.190122315496417400e+02,7.498477586679335616e+01,1.023647836408072891e+02,1.289117860721207194e+02,2.464270102103083957e+02,7.413227514530581175e+01,7.293652466236277121e+01,7.291344351266627655e+01,7.140157870511508520e+01,7.051404127904528707e+01,6.980139315367121355e+01,6.947589249778978626e+01,6.916483995507296356e+01,6.890248225188534548e+01,6.920079655279970154e+01,7.172697753540049348e+01
1.186179152672646779e+02,7.439099948689151631e+01,1.020326535126175145e+02,1.387030449316284830e+02,2.416657068018787697e+02,7.790978204260223094e+01,7.695018060879714028e+01,7.697148813191337524e+01,7.541422490526910849e+01,7.443650608234079868e+01,7.373524701078002863e+01,7.305418902846464846e+01,7.278709844212959013e+01,7.285931120588290355e+01,7.316648023484302144e+01,7.558474824967780137e+01
1.179639262078294593e+02,7.383901461344557049e+01,1.014419569231419302e+02,1.490291167783315416e+02,2.366298856996268398e+02,8.253747420840748816e+01,8.173089430942455635e+01,8.155116477794020113e+01,7.990761406699601821e+01,7.909834904738555394e+01,7.848643333176433146e+01,7.807883215271895949e+01,7.787872124470183621e+01,7.793471313354224606e+01,7.799946420275958303e+01,8.071070866034503410e+01
1.172147844021132386e+02,7.328305999507534807e+01,1.006689546604484349e+02,1.551345405469070329e+02,2.306462558335517770e+02,8.811531326626902683e+01,8.746758977453282569e+01,8.693662682689786436e+01,8.555156463840050662e+01,8.493144742213388554e+01,8.454251472823695224e+01,8.430159482760404899e+01,8.419285918259413393e+01,8.412247953991649752e+01,8.408500802888053727e+01,8.646561699491161335e+01
1.163865910953917790e+02,7.265958419917328115e+01,9.984078942944407231e+01,1.543078820119258978e+02,2.217352448050394855e+02,9.482117107599736983e+01,9.441001883742977441e+01,9.371078338243842154e+01,9.280072468837398958e+01,9.220445367773744749e+01,9.191480145897740783e+01,9.172476231064155172e+01,9.165998972712223747e+01,9.157709979594636707e+01,9.154904007630427998e+01,9.424190100678372062e+01
1.155581885779705402e+02,7.162068210037941185e+01,9.889371012097912228e+01,1.523867916587003606e+02,2.101857907165795893e+02,1.037046197589619112e+02,1.029978056248240961e+02,1.023859220956356779e+02,1.015553632094723611e+02,1.010985662978997510e+02,1.008023959010470350e+02,1.006730383062796506e+02,1.005792387340552523e+02,1.005646652611835208e+02,1.007495793500992676e+02,1.045921651083141910e+02
1.145191968596456888e+02,7.041761938818891053e+01,9.787571967534147177e+01,1.516213546636990372e+02,2.102825376978633756e+02,1.149782494257693628e+02,1.141057478283199202e+02,1.133196804589688753e+02,1.123933234380074850e+02,1.119461375196334103e+02,1.116699643907513888e+02,1.115732836322145261e+02,1.115016960127501875e+02,1.115709783972139491e+02,1.133786243791226553e+02,1.203205431295397432e+02
1.128277738202363594e+02,6.919949195019810873e+01,9.648865484798069758e+01,1.498823753047659579e+02,2.370671828140172011e+02,1.290428339633421615e+02,1.280042811508108684e+02,1.268718689376210165e+02,1.259406526778213760e+02,1.254726037727945993e+02,1.252999186850127984e+02,1.252166558255442226e+02,1.251563046666283725e+02,1.273016385561486743e+02,1.331126707531991542e+02,1.400008346578266583e+02
1.107683006286825673e+02,6.755181389793352764e+01,9.453689871126748301e+01,1.478371972045046334e+02,2.742775178375151768e+02,1.470699241027188577e+02,1.458116783009955384e+02,1.441779798949361862e+02,1.432977246354471106e+02,1.428687699169764187e+02,1.427379923692060686e+02,1.426666914589072519e+02,1.450494468962814381e+02,1.528541154798757873e+02,1.577644423188804979e+02,1.474417739837608963e+02
1.081712108972561879e+02,6.473924639745376908e+01,9.227819036905151506e+01,1.455183142298303380e+02,3.065920952896099720e+02,1.710029944667677171e+02,1.692917628747729566e+02,1.672059111611677054e+02,1.663442050116242683e+02,1.660902767068708101e+02,1.659759004674099288e+02,1.687673341519776500e+02,1.792136963141224442e+02,1.776933783654170043e+02,1.630754030979184108e+02,1.508668954597593483e+02
1.069933719536038552e+02,6.109008943919965873e+01,8.885927261707186631e+01,1.419181450883477567e+02,3.006750708294317178e+02,2.043033298466918950e+02,2.017033078467111693e+02,1.992732016469890084e+02,1.986148593555943478e+02,1.984972446783383191e+02,2.018471603687540323e+02,2.165215194577612010e+02,2.049948336525986861e+02,1.836332031721802878e+02,1.657210283161658992e+02,1.600509625226667652e+02
1.066501044957635855e+02,5.873834284234774117e+01,8.315160303602461056e+01,1.368310554969632165e+02,2.950718725939725005e+02,2.538284198267264742e+02,2.496356726871358944e+02,2.470499133918005157e+02,2.468570447118221693e+02,2.486151208549076728e+02,2.699331351193771980e+02,2.429836118125736846e+02,2.119621410827096781e+02,1.963338816849424120e+02,2.213889940358660908e+02,2.342724639903454715e+02
1.206075816602457564e+02,5.626665357849107352e+01,7.559729472462466049e+01,1.274382980466007496e+02,2.849081762706787799e+02,3.267740974245023722e+02,3.198117231866051497e+02,3.186648499002504877e+02,3.178797523920922004e+02,3.137613258383013317e+02,2.652589689204931460e+02,2.528325544695370297e+02,2.953580870924583905e+02,2.989999851096823704e+02,2.979939732303287201e+02,2.972789005691396369e+02
1.389313972410552651e+02,8.414442906362533847e+01,6.458597354398843038e+01,1.115330104385691783e+02,2.640865322796448140e+02,2.833611632364397224e+02,2.753229029885454793e+02,2.743215675883274116e+02,2.720374264051380919e+02,2.642608612303459950e+02,2.551462143455738385e+02,2.519429253154490027e+02,2.498539406349447063e+02,2.482567745578942038e+02,2.433260449221582462e+02,2.405254316916557400e+02
1.686058389309604024e+02,1.250503206793667346e+02,1.286162085738819769e+02,1.317532255898132973e+02,2.134738683549648215e+02,2.616537573572970814e+02,2.630106787466700098e+02,2.636343914787625522e+02,2.605336753952817617e+02,2.569920490389986298e+02,2.530272521494428020e+02,2.450818450050525428e+02,2.418851186827078550e+02,2.392723426260989186e+02,2.353555517479694004e+02,2.414735009049300061e+02
1.586272936030044036e+02,1.221178637403609315e+02,1.406133839862588104e+02,2.020962488699072992e+02,2.480384706080747037e+02,1.000000000000000000e+00,2.471103386899436600e+02,2.589595940787247628e+02,2.580722135931262073e+02,2.543272686603680768e+02,2.539079096261720565e+02,2.476224535946518017e+02,2.415764191006772421e+02,2.370602826769045066e+02,2.321837623843285314e+02,2.372462508075795995e+02
1.449998081843855857e+02,1.093192377890954532e+02,1.300108479676726461e+02,1.615779319684290840e+02,2.470544086086619302e+02,2.478847778376936901e+02,2.516760023803452100e+02,2.563987325195920448e+02,2.552454232663029359e+02,2.524482313893023502e+02,2.503296565165400409e+02,2.464425379780057312e+02,2.413371956444693751e+02,2.399882201179814558e+02,2.376109533581450535e+02,2.416789973521354966e+02
1.554337596257497296e+02,1.150601154428101722e+02,1.330789553454485485e+02,1.716044880424014138e+02,2.279928404339976851e+02,2.699132020236217500e+02,2.611783265005778958e+02,2.600613997116331575e+02,2.573105040540264667e+02,2.565999358996299406e+02,2.529491300933250102e+02,2.507549571558659522e+02,2.478628567790305794e+02,2.456995914185571053e+02,2.545726635704208434e+02,2.609029187110020871e+02
1.538090334202648535e+02,1.196545467163894898e+02,1.267021532591970470e+02,1.607515269022028690e+02,2.200795605472107468e+02,2.897295705717779128e+02,2.739763779426227188e+02,2.711469512067768051e+02,2.692292677337208602e+02,2.674044515486338582e+02,2.684296864108045497e+02,2.671492672095154717e+02,2.648662218168910272e+02,2.644899243214944136e+02,2.614651712829048051e+02,2.547115378842315749e+02
1.545509968318681331e+02,1.118262654623478056e+02,1.299496009647666597e+02,1.368470650014054399e+02,2.481892847128339099e+02,2.901821768941168784e+02,2.799762931763200413e+02,2.770344797638408068e+02,2.754055621363132218e+02,2.743426884438368347e+02,2.737282343001229492e+02,2.730267792721924138e+02,2.745810862446963370e+02,2.734010872140111701e+02,2.724032192022842196e+02,2.715656727741274494e+02
1.505084514686277259e+02,1.179377372933794135e+02,1.217510040456591298e+02,1.157679330419134232e+02,2.661405472793894091e+02,2.335322879812521819e+02,2.270440435635910603e+02,2.230075386986181059e+02,2.218592728414930093e+02,2.211910000710123541e+02,2.203671955564189773e+02,2.202215951694854539e+02,2.193653032554205140e+02,2.197527790560471317e+02,2.204706199673332492e+02,2.194095395260764576e+02
1.545944119958654994e+02,1.163744408090103661e+02,1.090041924071370119e+02,1.313976814814650425e+02,2.823855840004673610e+02,1.954360124671364076e+02,1.913455515567457041e+02,1.872200187857741298e+02,1.864963281941389823e+02,1.854554849507977679e+02,1.847528431370932083e+02,1.842097520082847097e+02,1.841029287146554054e+02,1.833550027308047845e+02,1.832004382426870279e+02,1.840629917508274787e+02
1.570711903161661382e+02,1.140092545701347859e+02,1.013982525363166474e+02,1.461539988282054310e+02,3.009483515185701208e+02,1.680629705578919300e+02,1.651681542152785767e+02,1.615465437911008735e+02,1.604663713343331892e+02,1.597240504890732495e+02,1.593035981490970983e+02,1.587009655572894644e+02,1.583022761198246258e+02,1.582892405040485357e+02,1.576645766059585867e+02,1.574561185379256472e+02
1.525368971552406663e+02,1.324283336933700070e+02,1.052074426305846231e+02,1.491298939407049318e+02,3.364303031830988857e+02,1.474449157566460826e+02,1.451655483452541660e+02,1.422317476879846083e+02,1.408658615417558053e+02,1.406433032472731668e+02,1.398829068287024029e+02,1.396146974406313461e+02,1.390794092848496177e+02,1.389881652521757758e+02,1.387863731197915911e+02,1.383849079126929098e+02
1.198697671893467032e+02,8.479673046085035537e+01,1.041189501994080615e+02,1.502849953437330441e+02,3.334621135433920358e+02,1.313563411544264170e+02,1.294871187408807032e+02,1.272127397725468683e+02,1.258070338670585784e+02,1.253944460494891615e+02,1.249080130558073876e+02,1.245438535193300424e+02,1.242558753600213350e+02,1.238306255455862726e+02,1.237768714448493057e+02,1.235682595679731293e+02
