Room No. 1 , Exit F, 
 dX[m], dY[m] , minX[m] , maxX[m], minY[m], maxY[m] 
   1.000000  ,  1.000000    ,  -5.000000  ,  11.000000  ,  -11.000000 ,  37.000000
8.888133821898684062e+00,2.826959643818687695e+00,2.779231508969203901e+00,2.861038786488498076e+00,7.498170847802987815e+00,1.327066971914705995e+01,1.451560826325979647e+01,1.351463255925269991e+01,1.110993788072084065e+01,1.090676672544507930e+01,1.202938172784077508e+01,1.131616226266646308e+01,1.073802481729904734e+01,1.089209227262282553e+01,1.106828328192139388e+01,1.162251093078945097e+01
9.336722181679503407e+00,2.868102608320131974e+00,2.817906254983095771e+00,2.904426712802630206e+00,8.023056011605904203e+00,1.369342740258822744e+01,1.475294474805911271e+01,1.337265877117976132e+01,1.128567971852255880e+01,1.139604863518015421e+01,1.200628209762143861e+01,1.143476356537420813e+01,1.094998360818805949e+01,1.117584962140610649e+01,1.138536235928836682e+01,1.204612986265351005e+01
9.358302051459119753e+00,2.910294457793502598e+00,2.858452800005929717e+00,2.948731657959385188e+00,8.048334513357719544e+00,1.433792635394351223e+01,1.500582795838871064e+01,1.317987182509092570e+01,1.143847048000601241e+01,1.191901531455729391e+01,1.197767034455162793e+01,1.152376549328350563e+01,1.119957001257056106e+01,1.141666542765104175e+01,1.176712144955968853e+01,1.248113913293654953e+01
9.996817639928195831e+00,2.954319816868230753e+00,2.900830053450815349e+00,2.992914322464979016e+00,8.100488128326162496e+00,1.522996804875344345e+01,1.527169683577928261e+01,1.298411861390011168e+01,1.158481896063704397e+01,1.246575840425717630e+01,1.207440501321411119e+01,1.161874049055013636e+01,1.148846290914949719e+01,1.169441817861689792e+01,1.223434804182314828e+01,1.288942953438898620e+01
1.116339149145945164e+01,3.000673373719537018e+00,2.944694361515927561e+00,3.042191804433926450e+00,8.216708788588352519e+00,1.620061319490024232e+01,1.555254390029250544e+01,1.282739313594234432e+01,1.172624875382789789e+01,1.302984677513913425e+01,1.232299103904194837e+01,1.173883199772490471e+01,1.181161018270895191e+01,1.204113041856823507e+01,1.272172479043659266e+01,1.322510875430932131e+01
1.173265754760866741e+01,3.007919632380875896e+00,2.990719277970181444e+00,3.093799712089081666e+00,8.400445341338201644e+00,1.689363252993354081e+01,1.585855510492348941e+01,1.275438758998521216e+01,1.188521480980454470e+01,1.349934810932399465e+01,1.260972827521489137e+01,1.193015594644367106e+01,1.216744853350554223e+01,1.242492001616050779e+01,1.323060869797823180e+01,1.360283256646392580e+01
1.177545510098241444e+01,2.989912867659219486e+00,3.032575571711243700e+00,3.133516705856029816e+00,8.556742996739899354e+00,1.724097021413308539e+01,1.620171789456252753e+01,1.280992841978387098e+01,1.217891933098160351e+01,1.371800912145953610e+01,1.279314984127269383e+01,1.221177127721346878e+01,1.246740971685830601e+01,1.290731566266932795e+01,1.373513193605082705e+01,1.402199699491811025e+01
1.182220365126414485e+01,2.987309815930381696e+00,3.042805384052072348e+00,3.152477271265346381e+00,8.466075544107582118e+00,1.753598664333030754e+01,1.657193051687723795e+01,1.300215346973953068e+01,1.270331313633470316e+01,1.369044697607964167e+01,1.290969555943493852e+01,1.254464320165920022e+01,1.279967779999097388e+01,1.347734781589725195e+01,1.416560880400655265e+01,1.447954244999355922e+01
1.186916745232097448e+01,2.998781522213445960e+00,3.050089421686687174e+00,3.181738093656456989e+00,7.917310212995706920e+00,1.792401916104539694e+01,1.691322583738457297e+01,1.327395523086852336e+01,1.339215536802278805e+01,1.367162925375536986e+01,1.303085541265702396e+01,1.292435137317301752e+01,1.322197704363233584e+01,1.407145990733097740e+01,1.458278365511521457e+01,1.494527127321764937e+01
1.191828108006682818e+01,3.035800858937413249e+00,3.070218946658078707e+00,3.218357223224573183e+00,6.967295998404002155e+00,1.832292993600447062e+01,1.711785845122328809e+01,1.354276683900597611e+01,1.412898509288599413e+01,1.386578862041408833e+01,1.318951838381395447e+01,1.336377987609173701e+01,1.369763590761194827e+01,1.468655279786336187e+01,1.506606971743696910e+01,1.563516650187754387e+01
1.197704352754290191e+01,3.079584018239688081e+00,3.096081874625812524e+00,3.266369890828465739e+00,6.056000264102149977e+00,1.849332336451164949e+01,1.688641960661230002e+01,1.356085634200371182e+01,1.469985655858360829e+01,1.403643914141887272e+01,1.325107021606742386e+01,1.354469367588509598e+01,1.410891337688672920e+01,1.504081400944499869e+01,1.539624744308653170e+01,1.696663666619090094e+01
1.202936195421442456e+01,3.129278446022923710e+00,3.138939077784951959e+00,3.309075751040833069e+00,5.652573131905609394e+00,1.801874896075318944e+01,1.580145979465828354e+01,1.292242630934858560e+01,1.457355003939779969e+01,1.349365082801645777e+01,1.278513505890294688e+01,1.310376694646524776e+01,1.396275084707031588e+01,1.466950443371406188e+01,1.508801270978590381e+01,1.698634219803041390e+01
1.204404760892609616e+01,3.180381866024646786e+00,3.182362703481903754e+00,3.361651194993934944e+00,6.422784130256512292e+00,1.802356994966242354e+01,1.507052950394848878e+01,1.274189092878191687e+01,1.455880527684253600e+01,1.327953804676533878e+01,1.294723834064410006e+01,1.331144317178328684e+01,1.431458778800481824e+01,1.485721727935279546e+01,1.525171838891320775e+01,1.695231318587358516e+01
1.204631543135394445e+01,3.233865238635515116e+00,3.228160993520480027e+00,3.413160073707744768e+00,8.002373489643247240e+00,1.811738279957954845e+01,1.439866286428030762e+01,1.269514529164933592e+01,1.413032887243356583e+01,1.309601878651490026e+01,1.317591135206459718e+01,1.364673411984014173e+01,1.469880058647030907e+01,1.507257761932114803e+01,1.535610065172398464e+01,1.732693625661284287e+01
1.208563918566002293e+01,3.291553784488938206e+00,3.286592075577835281e+00,3.469680999897850615e+00,8.770070191569018903e+00,1.825039781633875435e+01,1.394836964006523949e+01,1.310497239295583149e+01,1.380549946769215097e+01,1.299716263576976161e+01,1.332815054692922274e+01,1.405822476746008753e+01,1.498533688717698986e+01,1.530785864750987812e+01,1.534496562615763615e+01,1.776094389817573926e+01
1.214320734383885103e+01,3.351077448124870628e+00,3.340829878976611322e+00,3.538161155037324423e+00,8.872165004677238898e+00,1.839774665372724627e+01,1.374123765400988439e+01,1.376846099626093078e+01,1.379577442329653181e+01,1.304174264240343106e+01,1.356658716115318519e+01,1.455772198396174133e+01,1.519962431445503093e+01,1.556186287108647726e+01,1.545703997540878660e+01,1.818839415243028412e+01
1.218942762218311238e+01,3.413348254049713315e+00,3.403722287060976459e+00,3.615053049039180788e+00,8.978155429638999152e+00,1.859265944727761877e+01,1.375271980512330394e+01,1.447993177265462528e+01,1.390799172645332504e+01,1.323908616802457772e+01,1.395575163390544660e+01,1.511050872620935337e+01,1.550704709344955390e+01,1.578460026654257753e+01,1.592496066471126426e+01,1.849476250349922424e+01
1.223051918391588977e+01,3.484977465158512366e+00,3.464066013999695492e+00,3.680950484065393269e+00,9.088946952989958916e+00,1.879060092428301942e+01,1.377143617066887948e+01,1.520771642837244286e+01,1.375833287418204165e+01,1.347245355878571083e+01,1.440718262748504230e+01,1.554951397248282419e+01,1.580597909427486236e+01,1.584086325523347050e+01,1.654893101387835941e+01,1.871105520893122431e+01
1.228349737804778563e+01,3.533421507453935906e+00,3.530137305710892015e+00,3.760634796732778007e+00,9.211643526277766725e+00,1.903266922962115615e+01,1.367012231101485931e+01,1.545438652674928548e+01,1.354448705321207846e+01,1.376731109755059279e+01,1.489439109147927809e+01,1.581475254698685973e+01,1.608048860785007150e+01,1.614325434987281227e+01,1.690384280982921439e+01,1.881481959213774857e+01
1.234405169139199288e+01,3.586566443393128800e+00,3.599064626142743695e+00,3.859305716004835851e+00,9.350025385086631502e+00,1.913286977144394996e+01,1.346944181934889606e+01,1.493497969767523870e+01,1.346506432420260957e+01,1.415771715932577202e+01,1.541191112563674182e+01,1.604356372372831530e+01,1.632807787902472541e+01,1.674434174370654560e+01,1.720123707147402570e+01,1.883053915482553364e+01
1.240508632701464897e+01,3.667646974604975352e+00,3.671853029257477363e+00,3.969460766535676033e+00,9.503273368613411876e+00,1.870423470221978590e+01,1.333811916009816123e+01,1.451081251265215144e+01,1.362649677145620331e+01,1.464132377745925595e+01,1.596616822367260546e+01,1.631265822049397229e+01,1.648380339778298875e+01,1.720744979969114752e+01,1.739292307027254481e+01,1.874902587536629284e+01
1.246818301943644336e+01,3.760647321623621142e+00,3.757443666924102921e+00,4.089481270581224237e+00,9.673194532877406715e+00,1.762912673485205772e+01,1.389549072769267468e+01,1.466529549946890754e+01,1.397693911821326473e+01,1.522774691153748527e+01,1.636312922006958104e+01,1.667882035185694178e+01,1.702182558985051841e+01,1.766145750068747589e+01,1.743193682562876035e+01,1.901435284187519059e+01
1.252839005932794336e+01,3.853954407487984568e+00,3.848159933459252002e+00,4.217566639990545596e+00,9.863091556048765085e+00,1.634921098476634427e+01,1.499125033858688916e+01,1.465002277375592321e+01,1.441334079612050623e+01,1.582302247676569174e+01,1.663875779101199726e+01,1.702712336132286453e+01,1.769684373908053843e+01,1.798294046834043058e+01,1.739206925730213982e+01,1.964921344381651380e+01
1.258752168141174543e+01,3.942637587624338469e+00,3.956679262191189927e+00,4.357348605704602917e+00,1.007547508606538855e+01,1.534228002581863137e+01,1.619844708897853280e+01,1.437346654424153769e+01,1.497274409601730305e+01,1.653267261079775707e+01,1.707766494759584930e+01,1.745108562913810957e+01,1.830207082787707762e+01,1.807752915088393664e+01,1.791489029661555321e+01,1.975935773198365197e+01
1.263866626985782204e+01,4.040939625290121739e+00,4.069725993874797609e+00,4.509379472806301692e+00,1.031101379622345249e+01,1.496260664607190272e+01,1.689199285039367382e+01,1.432318474074235581e+01,1.566454006456148562e+01,1.718221905382645431e+01,1.762618886128522888e+01,1.823456705439213010e+01,1.875502430964336753e+01,1.823583725581380222e+01,1.857980496004606508e+01,1.971263019879668477e+01
1.263355453338054879e+01,4.150594798060314616e+00,4.189247443874138277e+00,4.678755032665491420e+00,1.057446867825599846e+01,1.497812471166417758e+01,1.607292450309842025e+01,1.469345808680458276e+01,1.653666127716632772e+01,1.764351615226205183e+01,1.821109482756685338e+01,1.907631457392037433e+01,1.895036593239177236e+01,1.885115566188498804e+01,1.846348882207794517e+01,2.012599761774694329e+01
1.265330912739105784e+01,4.276646755954217838e+00,4.331302818816139322e+00,4.864908796392294121e+00,1.087598587493899416e+01,1.478129334443408283e+01,1.576804302877722819e+01,1.530961726455416105e+01,1.747799434352623038e+01,1.837094470455949136e+01,1.892322604900133953e+01,1.977712035820271907e+01,1.929323166439790782e+01,1.966108767022854309e+01,1.858902203253059682e+01,2.043338122868884454e+01
1.272962957813514251e+01,4.415042366438921562e+00,4.469140231796977503e+00,5.068309057132621476e+00,1.119986313738788297e+01,1.446481389918993621e+01,1.604420268679956152e+01,1.617524597541203235e+01,1.848424147095400016e+01,1.913267875763023085e+01,2.003567480336927176e+01,2.028393950056732820e+01,2.011485610430555582e+01,1.933394128568517800e+01,1.912659822916316443e+01,2.048919609599420255e+01
1.283122046640172442e+01,4.553736187815195180e+00,4.628564693804976926e+00,5.303525485255484284e+00,1.153161525314236258e+01,1.534319593147819738e+01,1.567702873395059271e+01,1.728469191466559707e+01,1.920835962634046012e+01,1.993358004701678965e+01,2.114205994182961845e+01,2.079215065708388011e+01,2.087984117072985057e+01,1.973992719875737478e+01,1.922283247498229741e+01,2.076023093878585613e+01
1.294787323672913004e+01,4.640881995182407849e+00,4.810666379709557461e+00,5.573317623475483096e+00,1.212789890753909638e+01,1.763197885876769178e+01,1.578788238132695909e+01,1.862603515036047241e+01,2.022456624480935261e+01,2.119934512821764372e+01,2.199916704242013665e+01,2.177671793868026384e+01,2.052232675524025751e+01,2.024792651016201717e+01,1.952474341427083004e+01,2.243718384446327363e+01
1.319427721459012304e+01,4.762549696571489299e+00,4.968321456233751654e+00,5.879847024057925253e+00,1.209375238140901310e+01,1.976612840202430732e+01,1.671791598644339061e+01,2.022236592063342542e+01,2.140195464957544402e+01,2.279362132841777111e+01,2.264284808485037104e+01,2.243870758186512759e+01,2.115064896355793778e+01,2.028560314222592709e+01,2.084787747979921946e+01,2.293896612358680187e+01
1.372105566647807429e+01,4.929954713047600023e+00,5.190024307237538714e+00,6.224606520012732958e+00,9.454734523913515432e+00,1.855753010399297054e+01,1.822847261764509952e+01,2.163927302750693826e+01,2.264662042511383078e+01,2.417957559244730703e+01,2.382831782446568170e+01,2.224842289416894658e+01,2.135308014148435163e+01,2.098724194835436307e+01,2.191491009536575874e+01,2.375552070703391649e+01
1.443471129738298053e+01,4.972967135865413724e+00,5.426028668896960561e+00,6.536443822515775715e+00,8.185570563016202783e+00,1.892338474262171744e+01,2.030798363844134258e+01,2.311547611683770143e+01,2.473011586458759936e+01,2.495258512518955740e+01,2.438530796732397832e+01,2.306768501221592871e+01,2.188726319328088010e+01,2.296855132074477268e+01,2.281579995349202505e+01,2.452272684633405930e+01
1.511603914100327906e+01,5.053004946131852471e+00,5.630023778691237268e+00,6.802372030522396251e+00,1.120499456676517447e+01,1.856022870569332284e+01,2.272105017194613552e+01,2.478000223859122286e+01,2.691021427484265871e+01,2.646843611168492671e+01,2.460807330107754609e+01,2.330020941894942155e+01,2.446817679503135778e+01,2.393570026668417938e+01,2.371125935390412209e+01,2.537056359657080762e+01
1.573115964709915637e+01,5.276194430953056624e+00,5.875907744824285572e+00,7.228016506876296710e+00,1.352456161761857167e+01,1.925972259625629945e+01,2.531949283578852317e+01,2.700520162601299745e+01,2.798492966682575656e+01,2.659946830440120635e+01,2.505274935013928683e+01,2.521199046041853720e+01,2.531285330820935542e+01,2.506897307216731363e+01,2.470015388738975659e+01,2.636789661535495100e+01
1.656999243607268113e+01,5.547956475277403321e+00,6.249282412130499509e+00,7.813770774213739223e+00,1.413925678625152571e+01,1.954316038793411181e+01,2.514126380827236673e+01,2.799897829124920179e+01,2.689212117625475784e+01,2.588015048670186147e+01,2.480800587859416950e+01,2.471472963714813531e+01,2.439022369164294801e+01,2.393958816751872121e+01,2.394896176017978462e+01,2.196717730106782085e+01
1.690337243905700859e+01,5.903168798513348747e+00,6.717645295593222876e+00,8.588452169717804452e+00,1.521268389939146459e+01,2.075654574400194718e+01,2.533858968718507754e+01,2.732304206427264504e+01,2.591195926403825567e+01,2.466402761009059219e+01,2.429541812759171648e+01,2.394085983431143561e+01,2.348583672661501254e+01,2.223856029531273748e+01,2.332736051416032907e+01,2.149547945696143358e+01
1.728162610655277476e+01,6.350758147632731720e+00,7.319410100587163903e+00,9.646199676652072341e+00,1.182408051070366639e+01,2.247109843238029114e+01,2.658317604191919514e+01,2.603433967052208686e+01,2.467653989529710401e+01,2.442390756258090434e+01,2.359926605970052194e+01,2.285904617637273972e+01,2.235860016702249808e+01,2.164741562151693444e+01,2.285626856919981620e+01,2.097879859672865166e+01
1.775584875593921552e+01,6.904580764174998997e+00,8.028490187295432179e+00,9.409317242752548438e+00,9.532842055569924256e+00,2.248290562112545743e+01,2.638930833579483703e+01,2.427024072458964454e+01,2.387782040476308154e+01,2.336696078317312342e+01,2.238539896401620766e+01,2.179030224467714305e+01,2.123786903178968188e+01,2.140812779869347082e+01,2.131611588638311616e+01,1.837621336595429966e+01
1.811800467585842256e+01,7.569161844303711639e+00,8.198818367480633640e+00,7.702634199570384865e+00,1.045248583784048613e+01,2.281464864894149969e+01,2.398068770509419423e+01,2.270167711373233388e+01,2.229418421705961961e+01,2.115191908754631456e+01,2.061715134600173727e+01,1.993124778339866054e+01,1.941851753622008303e+01,1.763210896480205747e+01,1.816362043437032625e+01,1.521609935529508206e+01
1.849370132913362852e+01,8.779127766632521812e+00,8.673454945673789496e+00,6.867360420040022007e+00,1.019969206782930371e+01,2.482364496161329370e+01,2.122797910871517146e+01,2.099439926302855497e+01,1.972823959375848446e+01,1.896214196324916657e+01,1.812531710642482707e+01,1.655930679884816925e+01,1.508883849197487592e+01,1.394542083602059179e+01,1.465421914304071116e+01,1.039964655034576069e+01
1.857555945593310298e+01,9.405025906470255492e+00,9.063105028965612320e+00,6.216417198868637861e+00,1.037415227204536627e+01,1.719846501518251003e+01,1.579030865271759687e+01,1.436585494402086915e+01,1.359445733867405082e+01,1.171816519642651677e+01,9.637229987639711837e+00,8.007944926262283047e+00,6.757003532842879245e+00,5.776605380256771838e+00,4.975827588786433608e+00,3.793893350691155408e+00
1.806654874600338090e+01,9.485727725029152069e+00,9.120334464640185601e+00,6.394386870775494280e+00,1.131954566669103102e+01,1.929901834612705969e+01,1.743740210097989873e+01,1.618105489271400188e+01,1.246066125452047757e+01,9.601520424269178733e+00,7.539243820957167941e+00,6.019843781134503580e+00,4.819678231920443423e+00,3.860340036075290193e+00,3.074501683738812829e+00,2.355838866881886595e+00
1.752291807540225932e+01,9.259383465163727678e+00,9.019213847723454691e+00,7.168862581540426326e+00,1.271910084831027810e+01,2.381261885162509984e+01,2.008631605271643039e+01,1.367834842284690389e+01,9.640790877857281060e+00,6.951232835787698683e+00,4.990052974959617416e+00,3.485015934867115917e+00,2.173525729241323923e+00,1.296126877125852284e+00,1.051586580436572715e+00,1.090485177355599467e+00
2.133263818746495488e+01,9.675541018028237517e+00,7.497129500212301956e+00,5.760924913393704827e+00,2.402313610649430942e+01,2.482686120364383342e+01,1.359729432576860475e+01,7.592129278301540829e+00,3.613777856966172042e+00,1.215022804777188048e+00,1.149952246398000089e+00,1.007358232348757543e+00,1.056463734526026821e+00,1.046693602897328157e+00,1.023477020979592922e+00,1.006368975376550789e+00
5.336968993761602498e+00,5.235910053333713066e+00,3.024299037648439992e+00,2.539651343204734069e+00,5.399268963028508672e+00,1.437690178829933441e+00,1.137343691190957129e+00,1.007152282436950985e+00,1.008278573471695694e+00,1.009762720360226185e+00,1.020150820081579424e+00,1.024016408766569519e+00,1.024389313449446171e+00,1.023239659783906630e+00,1.021577071393270364e+00,1.019830497888894794e+00
1.050183553368669642e+00,1.043087614410532105e+00,1.019818262727608671e+00,1.053496124025218972e+00,1.057434196185471409e+00,1.043190714703808863e+00,1.033413451209806544e+00,1.026829843223840966e+00,1.021931206881797616e+00,1.018069097268688328e+00,1.015064531229537881e+00,1.012755281387291095e+00,1.010984876103469876e+00,1.009623572041693285e+00,1.008568011860095703e+00,1.007737105622052765e+00
1.008653006523067219e+00,1.007067516054580558e+00,1.007724629458089494e+00,1.012128704381086708e+00,1.019872174886035321e+00,1.022346335127100492e+00,1.021996341363953231e+00,1.020123742334773764e+00,1.018101667118692655e+00,1.016323059008165997e+00,1.014813533417911362e+00,1.013499723643753736e+00,1.012354894611954270e+00,1.011364974979314102e+00,1.010504814364434401e+00,1.009752973670313470e+00
