Room No. 1 , Exit F, 
 dX[m], dY[m] , minX[m] , maxX[m], minY[m], maxY[m] 
   1.000000  ,  1.000000    ,  -5.000000  ,  11.000000  ,  -11.000000 ,  37.000000
1.015815985246085944e+02,1.845867876562610199e+00,1.000183321988810548e+00,1.000000000000000000e+00,1.039745650222744455e+00,1.269039926217993468e+02,1.070217325257194574e+02,8.221892736931718559e+01,4.910551926551552526e+01,3.574698247173577670e+01,4.232764375569902171e+01,3.703757449200077900e+01,3.042282735491693657e+01,2.198657827091296468e+01,2.257231500925986367e+01,2.784933844964558247e+01
1.011937397249663491e+02,2.679899143479941515e+00,1.000189198739095175e+00,1.000000000000000000e+00,1.048791963885704615e+00,1.285247618557293663e+02,1.073097832802275207e+02,8.259176879032661134e+01,4.657297415951892106e+01,3.503528161823778220e+01,4.558665809099815647e+01,3.648697925764571437e+01,2.831468680181488295e+01,2.170498754054960600e+01,2.458204205122082442e+01,2.970458904190047633e+01
1.005058172042275828e+02,1.643875718607995751e+00,1.000195022336045625e+00,1.000000000000000000e+00,1.048027155686753753e+00,1.290649579767139699e+02,1.076396522197706247e+02,8.309123062408177418e+01,4.488852519430349020e+01,3.460132501587771969e+01,4.832650645021733737e+01,3.733544557415358156e+01,2.661258542361766999e+01,2.168222316873378475e+01,2.655352598057828217e+01,3.159918189022141632e+01
1.007677866428309699e+02,1.333077740284705603e+00,1.000203222299312245e+00,1.000000000000000000e+00,1.048009976009901312e+00,1.291589159641720812e+02,1.077472561370738191e+02,8.339511229954088378e+01,4.410312378436576353e+01,3.556646342390576621e+01,4.917550196284728514e+01,3.799752823543123981e+01,2.537139207905823568e+01,2.245955500389820969e+01,2.853103243412161305e+01,3.357281156778309139e+01
1.007981503593350538e+02,1.423610245912675376e+00,1.000213295904270883e+00,1.000000000000000000e+00,1.049430783853327442e+00,1.285119418488170311e+02,1.078512566878823407e+02,8.286634823776213921e+01,4.390643578252608847e+01,3.849501940504097774e+01,4.740341282341112361e+01,3.694606395728387582e+01,2.460106869812888064e+01,2.430496198745989389e+01,3.064731720276265747e+01,3.576359404586864343e+01
1.007564512695399941e+02,2.314197593404948350e+00,1.000222727079949969e+00,1.000000000000000000e+00,1.052920328354980839e+00,1.276680750105424522e+02,1.080412155290771352e+02,8.089045125436970807e+01,4.382550456644423775e+01,4.256422514447420014e+01,4.415818281278055935e+01,3.440443472532493985e+01,2.415926614610366840e+01,2.671240187952830780e+01,3.286774542222600104e+01,3.816830051231958265e+01
1.007503835396954628e+02,2.313968746233234342e+00,1.000231470328947658e+00,1.000000000000000000e+00,1.058100229698284434e+00,1.269663629747862359e+02,1.082523311939683879e+02,7.726533526265092178e+01,4.359933549107031325e+01,4.675181476685302329e+01,4.178786727827925773e+01,3.172062481073643170e+01,2.391563513106754257e+01,2.910270405304430952e+01,3.514020378907080300e+01,4.030502042400660656e+01
1.007440060333769054e+02,2.313720632360811713e+00,1.000240725765844774e+00,1.000000000000000000e+00,1.062811055818110528e+00,1.261761162286291409e+02,1.084673914634879566e+02,7.241055829410092315e+01,4.316780927769015364e+01,5.109926099359199725e+01,4.183600553915693609e+01,2.960282322835423585e+01,2.441841884074604963e+01,3.150226939987592090e+01,3.757420339296083256e+01,4.148659145878515631e+01
1.007372944003362676e+02,2.313451168856917484e+00,1.000250530955360206e+00,1.000000000000000000e+00,1.063048210220965961e+00,1.253160984562893958e+02,1.086761248781207598e+02,6.708607654966942846e+01,4.235501318629351175e+01,5.529086797034810985e+01,4.311701850163605343e+01,2.814471112508017825e+01,2.634632299207429185e+01,3.408712226127843792e+01,4.033739448076568834e+01,4.180050333528678408e+01
1.007302216652785489e+02,2.313165119862832242e+00,1.000260926419801688e+00,1.000000000000000000e+00,1.053212439432981817e+00,1.256228080527560991e+02,1.088223691755962506e+02,6.202113837033298438e+01,4.139283528704020654e+01,5.722825909011615408e+01,4.264104794015017319e+01,2.732960607738522896e+01,2.925905058307990814e+01,3.678855025994248251e+01,4.311208554245173730e+01,4.204968417653567059e+01
1.007227578631597993e+02,2.312852890985974241e+00,1.000271955806257163e+00,1.000000000000000000e+00,1.030544164736216128e+00,1.281103407147386690e+02,1.088994066321762517e+02,5.793481290771828185e+01,4.203982933868793737e+01,5.511591210562428245e+01,3.962096075261237615e+01,2.686720766141350936e+01,3.221677199121037916e+01,3.958151742906311910e+01,4.492758957447785662e+01,4.251320130394179841e+01
1.007148696116302347e+02,2.312520271885676770e+00,1.000283666018655149e+00,1.000000000000000000e+00,1.005179229974609845e+00,1.242943972577729710e+02,1.004864548952701853e+02,4.693730415620178320e+01,3.742457336034963333e+01,4.217360486670366271e+01,2.754743221976637457e+01,1.841021022235846871e+01,2.663821421828300373e+01,3.414447721212987119e+01,3.691317972777261502e+01,3.636525353491913393e+01
1.007065196075247542e+02,2.312155169889919648e+00,1.000296107302314663e+00,1.000000000000000000e+00,1.005406540111171143e+00,1.356061651320203509e+02,1.007170524724078717e+02,4.587568758571455874e+01,4.306568767990639657e+01,3.946944740509447769e+01,2.459395182721465289e+01,2.001362105150583659e+01,2.961530632904510441e+01,3.735094520828343434e+01,3.693451688739119021e+01,3.664825232416113465e+01
1.006976660310557179e+02,2.311764689071738932e+00,1.000309333264060907e+00,1.000000000000000000e+00,1.033681692732890456e+00,1.480111409110274963e+02,1.013088596351397968e+02,4.547112062670865384e+01,4.885093210185490875e+01,4.034709039696898003e+01,2.261424893459967933e+01,2.329067386329183265e+01,3.270466378120231354e+01,3.980885311390620984e+01,3.722701597900864101e+01,3.686451305991004546e+01
1.006882618371694207e+02,2.311333373733720276e+00,1.000323400781271799e+00,1.000000000000000000e+00,1.051255478318687597e+00,1.518492714836162349e+02,1.013653183635574919e+02,4.486996329915298531e+01,5.489838818213210914e+01,4.077609601442089371e+01,2.147699527876599390e+01,2.676012206447737185e+01,3.598167896165399782e+01,4.050190968082029741e+01,3.754599176550521378e+01,3.692698538990808288e+01
1.006782539080810750e+02,2.310870034038970289e+00,1.000338369733190236e+00,1.000000000000000000e+00,1.051312657028828479e+00,1.518358923289394795e+02,9.891196228665776857e+01,4.383211292827822803e+01,5.868906547716244404e+01,3.709021987690021405e+01,2.080129762163899088e+01,3.024111521790060664e+01,3.979679448209932247e+01,4.049995758238041077e+01,3.788323949999134754e+01,3.778210457618283158e+01
1.006675820338532645e+02,2.310354603718652644e+00,1.000354302465305434e+00,1.000000000000000000e+00,1.051374619142310785e+00,1.518130800754850611e+02,9.263588008809486496e+01,4.202965724408707615e+01,5.593668498273334677e+01,3.195982569774084325e+01,2.194622313600989116e+01,3.404267217085102715e+01,4.339680621443045538e+01,4.083833649202638583e+01,3.807965681126499646e+01,4.043698349995370478e+01
1.006561776937077184e+02,2.309798138862802830e+00,1.000371262884648837e+00,1.000000000000000000e+00,1.051434611543507369e+00,1.517785511604236035e+02,8.347696347295762109e+01,4.139875128784967018e+01,4.939139264309355326e+01,2.804746677929857057e+01,2.588429661637643164e+01,3.798982685977065188e+01,4.484574426875155950e+01,4.122314413478644468e+01,3.827312069566911390e+01,4.399054031717685831e+01
1.006439626165247887e+02,2.309174121187180795e+00,1.000389315007079949e+00,1.000000000000000000e+00,1.051480583013077785e+00,1.517462190652985612e+02,7.376879707235868011e+01,4.649907452809299002e+01,4.717046940760840812e+01,2.568336877128387385e+01,3.042736166393420660e+01,4.240820804101676345e+01,4.485890117585707770e+01,4.162873878738066935e+01,4.015092843519548893e+01,4.763610680637112438e+01
1.006308469329963913e+02,2.308496611052953895e+00,1.000408520719191063e+00,1.000000000000000000e+00,1.051494638250588309e+00,1.517533287496362675e+02,6.577233655645348165e+01,5.534663766091180293e+01,4.900501430723600294e+01,2.438774911847053772e+01,3.500370806200980667e+01,4.734226664547225738e+01,4.524909584038717014e+01,4.178352004720174762e+01,4.403067595288661806e+01,5.015905437046335891e+01
1.006167269365123218e+02,2.307729849235157005e+00,1.000428936374741617e+00,1.000000000000000000e+00,1.051462797963224283e+00,1.518068073176909536e+02,6.152042839509765315e+01,6.455905672495850922e+01,4.547515628468757143e+01,2.458852701710623734e+01,4.001821441546749014e+01,5.015898287349126150e+01,4.572454061235708167e+01,4.248084557132703054e+01,4.837763300163342706e+01,5.089334214558626002e+01
1.006014823852522255e+02,2.306891989782281271e+00,1.000450607746056653e+00,1.000000000000000000e+00,1.051393224991849396e+00,1.517770283517835423e+02,6.040827997986304609e+01,7.249811484463504030e+01,3.812703154450090892e+01,2.912401583342143141e+01,4.530111598336841183e+01,5.030908163360313523e+01,4.620279965991235116e+01,4.603026256600143995e+01,5.203395051481373201e+01,5.175491013065447987e+01
1.005849729945566082e+02,2.305933684981719356e+00,1.000473562640815883e+00,1.000000000000000000e+00,1.051339270514828783e+00,1.514801791628697174e+02,5.943197934710951813e+01,6.961399377169252034e+01,3.271767614917523304e+01,3.531206542191519304e+01,5.157154845828947742e+01,5.075817958217823644e+01,4.634519239941147362e+01,5.116909270241897900e+01,5.323368510074769233e+01,5.277046302420610147e+01
1.005670340680754578e+02,2.304878791786956427e+00,1.000497800111272761e+00,1.000000000000000000e+00,1.051435692867196625e+00,1.514008972836969349e+02,5.735604006788383913e+01,5.993248943224467951e+01,2.989620796531009006e+01,4.159649251224923461e+01,5.666646216112672363e+01,5.136123395218947252e+01,4.840783773137765422e+01,5.616325614150245116e+01,5.417496289451058544e+01,5.372122412889249432e+01
1.005494236943212769e+02,2.303657367541466883e+00,1.000523274759865355e+00,1.000000000000000000e+00,1.051881034822907290e+00,1.525365953909300742e+02,5.447615128814058494e+01,5.993223658537755227e+01,2.869668351882436141e+01,4.848725832593050455e+01,5.732301874578411827e+01,5.189883775671017219e+01,5.413046435272687518e+01,5.830485036515105435e+01,5.538734084327900575e+01,5.174663236138417233e+01
1.005282879149172857e+02,2.302301434294322213e+00,1.000549873905082654e+00,1.000000000000000000e+00,1.052682135109568096e+00,1.514252481669479096e+02,6.159423559526371150e+01,5.850416095305364905e+01,3.328155449750614991e+01,5.614637447912843982e+01,5.783466948457904522e+01,5.232617076859488492e+01,6.059037092238735056e+01,5.933365837741674653e+01,5.648935930889351908e+01,4.162889850610366693e+01
1.005048567748052619e+02,2.300708752644863075e+00,1.000577384313551921e+00,1.000000000000000000e+00,1.053259843167376308e+00,1.395228641476577991e+02,7.735097562329029586e+01,4.736224116390344818e+01,4.214116582142255396e+01,6.449237477063590518e+01,5.862606586008114107e+01,5.723654200847186502e+01,6.442901586334123465e+01,6.080160057126600748e+01,5.200108544985909731e+01,4.261734194419383215e+01
1.004790521157081287e+02,2.299115377350534839e+00,1.000605443881650292e+00,1.000000000000000000e+00,1.052064836585091090e+00,1.184171667970473720e+02,9.359115788596743357e+01,3.944112796473400095e+01,5.129617860351446978e+01,6.668490525297805505e+01,5.916965754415756606e+01,6.530847965397354926e+01,6.560721457513585619e+01,6.215071062042859040e+01,4.354482831419675648e+01,4.400802431670177128e+01
1.004506123065415153e+02,2.297010927861737439e+00,1.000633471035652589e+00,1.000000000000000000e+00,1.048791384060548726e+00,9.927636057685637638e+01,9.235888484396600973e+01,3.601801989946906701e+01,6.137681858024765091e+01,6.725592864659255099e+01,6.115438222036644333e+01,7.177789441494672928e+01,6.741246140743407977e+01,5.442273968030703202e+01,4.475670313613558449e+01,4.619438026252664997e+01
1.004184850320983600e+02,2.294632543700712901e+00,1.000660561574959306e+00,1.000000000000000000e+00,1.049853968970529072e+00,9.178251865696198308e+01,7.771430996740095054e+01,3.891808832974951571e+01,7.349615347958639688e+01,6.834399461506437490e+01,7.040295282705326940e+01,7.340220309221602690e+01,6.922892189294151422e+01,4.816098051482844511e+01,4.677300508898492382e+01,4.914451706817254717e+01
1.003825109872679491e+02,2.291723146318708437e+00,1.000685338616795095e+00,1.000000000000000000e+00,1.064320374557936599e+00,8.975809038396963047e+01,8.030522680389795198e+01,5.236281147701487271e+01,7.976718833248372675e+01,6.888171570534163379e+01,8.043024105716592942e+01,7.566545624015046201e+01,5.621605188977338941e+01,4.986298144511512476e+01,4.981992129947368397e+01,6.621926087561038798e+01
1.003422111986805589e+02,2.288388588135640944e+00,1.000705736139323010e+00,1.000000000000000000e+00,1.056367061187849954e+00,8.407503449511220595e+01,6.271378095829122401e+01,6.687130140161755776e+01,8.042438232698597744e+01,7.586991121070521160e+01,8.338424877612186492e+01,7.826536104552208428e+01,5.386259334295989021e+01,5.287808425921370770e+01,6.047514658418469935e+01,7.552842203684029698e+01
1.003009183136699107e+02,2.284194977340956889e+00,1.000718693069173160e+00,1.000000000000000000e+00,1.003394396918252163e+00,9.295869550457493347e+01,5.019409964507038069e+01,8.352824287113301693e+01,8.197938692225551449e+01,9.018750365594029006e+01,8.626401268863199334e+01,5.895802907576620555e+01,5.655058957329854508e+01,5.674401292633434224e+01,7.874302662262213914e+01,8.082080420396954423e+01
1.002467020818890973e+02,2.279300890154757564e+00,1.000719742225618658e+00,1.000000000000000000e+00,1.003191117969209900e+00,1.276210270817617101e+02,4.799746417351883565e+01,9.895642129647868046e+01,8.365985746563895020e+01,9.666357646024367511e+01,8.887088297863655839e+01,6.133006812077110936e+01,6.106512538750677521e+01,8.474947594720630661e+01,8.477326366284762571e+01,8.690588065060343581e+01
1.001870653124057355e+02,2.272914212268493106e+00,1.000702525563352596e+00,1.000000000000000000e+00,1.054275327761757364e+00,1.376459069817045133e+02,6.934365931111469195e+01,1.001197400605634442e+02,1.009566111413932674e+02,1.003691516991305974e+02,6.807190579958570709e+01,6.575869874600253695e+01,8.523845950573230823e+01,9.166125113285738735e+01,9.188711464759211367e+01,9.416761202994305791e+01
1.001237091370626615e+02,2.265275189274050138e+00,1.000658438829625574e+00,1.000000000000000000e+00,1.051366822410897850e+00,1.172508265231900708e+02,9.331551132208136323e+01,1.001322604501559255e+02,1.129243318245321603e+02,9.830715819365512687e+01,7.165779120409034419e+01,7.528924612752167889e+01,9.772739043518568280e+01,9.793768385889119088e+01,9.826798218077458102e+01,1.167740731340929869e+02
1.000409255639123671e+02,2.254771908018806670e+00,1.000577232662553495e+00,1.000000000000000000e+00,1.054559936075602611e+00,6.523395658922974860e+01,9.766475174428860839e+01,8.323481055445374466e+01,9.032466910147404349e+01,8.005804637813697866e+01,7.907592218397653028e+01,7.984207871441600446e+01,8.014465404200548448e+01,8.045692051952562451e+01,8.261225481287060290e+01,1.060931176204023672e+02
9.993608175009217121e+01,2.243236252151888710e+00,1.000449708032913776e+00,1.000000000000000000e+00,1.049313572799171146e+00,3.894214027206768236e+01,9.982074283566819872e+01,1.088368070516269768e+02,9.291572320540169017e+01,8.714189252718610135e+01,8.840485434953772881e+01,8.881592437266961326e+01,8.921674087300378631e+01,8.926759668793950198e+01,9.252832990276839098e+01,1.134322137942228750e+02
9.982310024701803286e+01,2.224570433538063163e+00,1.000270383794066076e+00,1.000000000000000000e+00,1.003330153799318447e+00,6.572337512958311834e+01,9.889727293404531849e+01,1.124052277357316854e+02,9.820529884275892130e+01,9.909052888345667043e+01,9.959245697518714735e+01,1.001462485934763151e+02,1.003235092693290085e+02,1.015509173684496744e+02,9.964068706014245436e+01,1.158752611303516176e+02
9.968418085380163518e+01,2.199996485666712687e+00,1.000046217320174957e+00,1.000000000000000000e+00,1.014125602743871202e+00,1.226377836618482178e+02,1.359102896660095041e+02,1.166284473428464423e+02,1.124027765641248209e+02,1.134809450307474918e+02,1.140181370971758383e+02,1.145361572022023182e+02,1.152756620336090094e+02,1.078953373996991871e+02,1.021639924512363393e+02,1.174705733569376491e+02
9.950630557082004657e+01,2.164239463219126414e+00,1.000181920741406882e+00,1.000000000000000000e+00,1.036150403023624156e+00,1.496867410690855706e+02,1.489860494487327003e+02,1.295964247238704274e+02,1.317927930399844456e+02,1.326844128415233968e+02,1.336333829926712156e+02,1.319777289752052241e+02,1.207797680824302375e+02,1.105577149806732677e+02,1.036599569139968651e+02,1.187822942373101682e+02
9.927515959294301240e+01,2.107832465592954563e+00,1.000309369904327506e+00,1.000000000000000000e+00,1.031501075845522308e+00,1.600971048765912883e+02,1.529404259426906378e+02,1.528303311417048178e+02,1.539954722950643315e+02,1.559504732319387585e+02,1.479634199384226463e+02,1.324727099124634151e+02,1.188079064278227435e+02,1.078466574829354414e+02,9.908578703473551741e+01,7.287951889228673963e+01
9.896666610388039942e+01,2.012533447478488391e+00,1.000233135611705793e+00,1.000000000000000000e+00,1.066823754857996409e+00,1.488472440447775398e+02,1.217701714017250225e+02,1.236742564738510737e+02,1.267002735129534443e+02,1.058780175851770906e+02,8.347589783365523886e+01,6.575645309853416620e+01,5.237817905447138145e+01,4.179919475017144492e+01,3.306351502160523381e+01,2.588078083256530348e+01
9.847126954193242909e+01,1.873103500049638992e+00,1.000050369470387279e+00,1.000000000000000000e+00,1.006742517461443054e+00,1.582532186718761125e+02,1.635697902054400856e+02,1.623887353718759812e+02,1.199394796949324871e+02,8.702331941416282746e+01,6.424427152697784038e+01,4.726210231223752345e+01,3.408402027868196882e+01,2.355856680000325198e+01,1.404372555799734279e+01,6.412541304132111541e+00
1.350812891915495300e+02,1.728572706879480947e+00,1.000103140918580102e+00,1.000000000000000000e+00,1.503807900539122056e+00,2.423366756041291978e+02,2.078273130093005534e+02,1.290147533200080545e+02,8.182680773921693174e+01,5.036345883995913653e+01,2.738362848245026271e+01,9.084652336127007288e+00,1.202502164282544195e+00,2.264685934698971170e+00,1.432618710561299746e+00,1.174871020538722721e+00
2.079560301465934344e+02,1.582524934729494817e+02,1.022879020129050520e+00,1.000000000000000000e+00,1.641428975479099392e+02,2.511798734390672223e+02,9.808508491557356024e+01,1.696502482098399156e+01,3.506390850336464027e+00,1.346380456103783985e+00,1.503356754682348528e+00,1.036978609452650968e+00,1.186855323372084658e+00,1.212513671436629359e+00,1.164698889143131799e+00,1.105536161332527634e+00
1.000000000000000000e+00,1.000000000000000000e+00,1.000000000000000000e+00,1.000000000000000000e+00,1.000000000000000000e+00,1.000000000000000222e+00,1.000000000000000000e+00,1.000000000000000000e+00,1.000000000000000000e+00,1.000000000000000000e+00,1.000000000000000000e+00,1.000000000000000000e+00,1.000000000000000000e+00,1.000000000000000000e+00,1.000000000000000000e+00,1.000000000000000000e+00
1.000014811058688613e+00,1.000000966160788707e+00,1.000000214805789378e+00,1.000000000000000000e+00,1.000011351052285891e+00,1.000194902614336412e+00,1.000839609999878643e+00,1.000008390351336374e+00,1.002325544995050999e+00,1.003298934290453692e+00,1.003343700694426133e+00,1.003090974287597748e+00,1.002445434934810642e+00,1.001309222041346203e+00,1.000266400421840007e+00,1.002075860433073506e+00
