Room No. 1 , Exit F, 
 dX[m], dY[m] , minX[m] , maxX[m], minY[m], maxY[m] 
   1.000000  ,  1.000000    ,  -5.000000  ,  11.000000  ,  -11.000000 ,  37.000000
1.015815986855955657e+02,1.845824340980268374e+00,1.000474080977407976e+00,1.001461227642632679e+00,1.045398248792631213e+00,1.269221506970985587e+02,1.070526887202798463e+02,8.225331673437507618e+01,4.916257128357973016e+01,3.596551323088559116e+01,4.275234409166243665e+01,3.759391342721724527e+01,3.138800553179006769e+01,2.384389860749904599e+01,2.494225201740701792e+01,3.021154839937739567e+01
1.011937398204757415e+02,2.679864162849201481e+00,1.000463181375906396e+00,1.001493627051421642e+00,1.054775895356017790e+00,1.285439907167518925e+02,1.073420363099453141e+02,8.262690708483295055e+01,4.664109702271230162e+01,3.528891553009071913e+01,4.604694614777252326e+01,3.704931931850161675e+01,2.950133233887796536e+01,2.380064860833681095e+01,2.701195663117479384e+01,3.208099596494396621e+01
1.005058172457329846e+02,1.643848446796964957e+00,1.000451271276279197e+00,1.001527495798784306e+00,1.054371822697823147e+00,1.290853382273056411e+02,1.076732395090246683e+02,8.312722577640023758e+01,4.497116610516373925e+01,3.489304721456088032e+01,4.882219337443903129e+01,3.789867729837173727e+01,2.801570822396599780e+01,2.400349345937425483e+01,2.904790189834375269e+01,3.399273931908695090e+01
1.007677866402562898e+02,1.333098242317252602e+00,1.000435815056043287e+00,1.001562936156713768e+00,1.054748104751294768e+00,1.291805348581000317e+02,1.077822088955326052e+02,8.343217540860773340e+01,4.420450474917148398e+01,3.589902257757630366e+01,4.970709396189863583e+01,3.861700436772107281e+01,2.700595191344477897e+01,2.495102531147473357e+01,3.108045830349145433e+01,3.599715342793148665e+01
1.007981503232358875e+02,1.423595493008750879e+00,1.000417201144034651e+00,1.001600060113991164e+00,1.056598879175073114e+00,1.285348937639463998e+02,1.078875893614038262e+02,8.290487183402396454e+01,4.403155873229231787e+01,3.887074745423535660e+01,4.797421377343295035e+01,3.773629920002466065e+01,2.649513415033791475e+01,2.689762206899926511e+01,3.322724453545701095e+01,3.823135701332880387e+01
1.007564512131272494e+02,2.314187507916797060e+00,1.000397823312671353e+00,1.001638990558237019e+00,1.060559205128045468e+00,1.276924620777490418e+02,1.080789160516938523e+02,8.093113108706472758e+01,4.397998270728140113e+01,4.298507984617660327e+01,4.477028736436055567e+01,3.545851322843279974e+01,2.633945381443217570e+01,2.937794357150162483e+01,3.546371102170544276e+01,4.068614549590653695e+01
1.007503834764431332e+02,2.313962218703010443e+00,1.000377597869353430e+00,1.001679862634819784e+00,1.066255733713279197e+00,1.269922952275284445e+02,1.082913654714585050e+02,7.730932215500587290e+01,4.378915572719955662e+01,4.721964117389764226e+01,4.242782018983770342e+01,3.305523275545954931e+01,2.638755869884782612e+01,3.184591302296875170e+01,3.776113019190878362e+01,4.289085355583691950e+01
1.007440059761017324e+02,2.313716578310608618e+00,1.000355187941984969e+00,1.001722825314284027e+00,1.071535088235007205e+00,1.262037071677366384e+02,1.085077225034614230e+02,7.245964067503697947e+01,4.339903777784549987e+01,5.161532175162107450e+01,4.247689619252614790e+01,3.121203082505258664e+01,2.713204920657537400e+01,3.431064470643883624e+01,4.023868631956955255e+01,4.419530776210416434e+01
1.007372943592401953e+02,2.313448610377760950e+00,1.000330408048224706e+00,1.001768043206606507e+00,1.072399868319330762e+00,1.253454602816090073e+02,1.087177181516029378e+02,6.714290974196910611e+01,4.263352947202493937e+01,5.585520996491754886e+01,4.378364826599383264e+01,3.005293133553190899e+01,2.920630396853327682e+01,3.692831333980062425e+01,4.305772590771098152e+01,4.470304976499566862e+01
1.007302216454740460e+02,2.313163303113274338e+00,1.000303061463212906e+00,1.001815698668847565e+00,1.063259024952144083e+00,1.256540537636812758e+02,1.088651857500926923e+02,6.208953022906937491e+01,4.172405880681133539e+01,5.784107768684942386e+01,4.347398849283000288e+01,2.957750236855470405e+01,3.221086282762449571e+01,3.964972782271723162e+01,4.590105332260674231e+01,4.516999385489311436e+01
1.007227578635231851e+02,2.312851428262217013e+00,1.000272953499926398e+00,1.001865994263089199e+00,1.041362280609492430e+00,1.281435878609766519e+02,1.089434138351192303e+02,5.801991954817966501e+01,4.242867520731368103e+01,5.578158407582834144e+01,4.077923733118170446e+01,2.948535214571516150e+01,3.526396181314007094e+01,4.248060893328268861e+01,4.783711593040795407e+01,4.583982490699746393e+01
1.007148696262930230e+02,2.312519086946464242e+00,1.000239895574933202e+00,1.001919155634509062e+00,1.016855864092934603e+00,1.243297741667565504e+02,1.005316540543733907e+02,4.704586528203755336e+01,3.787523260409236059e+01,4.289472823783047062e+01,2.907215858219068849e+01,2.137161852031085374e+01,2.976361177626247567e+01,3.710443229173498025e+01,4.003629830870772821e+01,3.990996230618936380e+01
1.007065196277262658e+02,2.312154242847539898e+00,1.000203678748461833e+00,1.001975434895832073e+00,1.018040738195979067e+00,1.356438143862530126e+02,1.007635249872259067e+02,4.601633490235041535e+01,4.358156565654054049e+01,4.021882921528403898e+01,2.647867280104557253e+01,2.319828028380674922e+01,3.277599808881317500e+01,4.038444819332432445e+01,4.031665413696583045e+01,4.044354880187509593e+01
1.006976660486955666e+02,2.311763997556915307e+00,1.000164086233652272e+00,1.002035114625241974e+00,1.047386598749871389e+00,1.480512219305068982e+02,1.013568169226698217e+02,4.565424425533851149e+01,4.943507100624286466e+01,4.109751465770727918e+01,2.490036549945342870e+01,2.659776415672459748e+01,3.589373544245288628e+01,4.295869799273899758e+01,4.085516994918383205e+01,4.094052538691804699e+01
1.006882618468512192e+02,2.311332893103298147e+00,1.000120915328737814e+00,1.002098512611516723e+00,1.066160664452463269e+00,1.518919517489150337e+02,1.014152719163020322e+02,4.510709012340601021e+01,5.555214485200419006e+01,4.165894190241346706e+01,2.422416298505162047e+01,3.018703493996591192e+01,3.922955916815063659e+01,4.388227015294602040e+01,4.143528835707726188e+01,4.131171640572963355e+01
1.006782539089534652e+02,2.310869737946850577e+00,1.000073994235037400e+00,1.002165987514563206e+00,1.067566917051987030e+00,1.518813267622090279e+02,9.896506481166309754e+01,4.413505842968243087e+01,5.941225701516562907e+01,3.837040866336972300e+01,2.402763814050430113e+01,3.376338283401750573e+01,4.312790723445645114e+01,4.419119897247495032e+01,4.207585514818333650e+01,4.245114718160674983e+01
1.006675820288376144e+02,2.310354460614189698e+00,1.000023206480823657e+00,1.002237945654215867e+00,1.069149297472401949e+00,1.518614057462437756e+02,9.269448056594981722e+01,4.240968733476230312e+01,5.673505606704271997e+01,3.373783641735360561e+01,2.552803507310681042e+01,3.760344053842290890e+01,4.684182990763571297e+01,4.482817935771657858e+01,4.261400097269798692e+01,4.520952248720231381e+01
1.006561776877523329e+02,2.309798111342677984e+00,1.000031472975281055e+00,1.002314849198680191e+00,1.070927573492391094e+00,1.518298919847650836e+02,8.354533114408158667e+01,4.186593824480488735e+01,5.026733750251891308e+01,3.031852845577846622e+01,2.964396751484468950e+01,4.159640180622863426e+01,4.853145660668727146e+01,4.553128566043708503e+01,4.317854157294032547e+01,4.865275605712911755e+01
1.006439626132365817e+02,2.309174175275054086e+00,1.000089924481601944e+00,1.002397226101252370e+00,1.072920952636404746e+00,1.518006527274817472e+02,7.385410078525896438e+01,4.706199584231941202e+01,4.806803200545778765e+01,2.852114923051780693e+01,3.434213366405825951e+01,4.610561234965120292e+01,4.892042669598615134e+01,4.631114225438039256e+01,4.532842874682458501e+01,5.217669878031100694e+01
1.006308469330933661e+02,2.308496703206760259e+00,1.000151805339374755e+00,1.002485682236857079e+00,1.075148422869188991e+00,1.518108155888055819e+02,6.588570651277254342e+01,5.601200709101306074e+01,4.996382884298549243e+01,2.787542653142806159e+01,3.903676429463460096e+01,5.115933252603625903e+01,4.968066285831097417e+01,4.689082476716797032e+01,4.918665353739143598e+01,5.466375461719778173e+01
1.006167269382861633e+02,2.307729935036376023e+00,1.000216433967531460e+00,1.002580916328328575e+00,1.077640370357570765e+00,1.518672257267648433e+02,6.167787706544694970e+01,6.533216675789938677e+01,4.689571238425867250e+01,2.865382341409875266e+01,4.409610419048114949e+01,5.421706874574830692e+01,5.055278969226340280e+01,4.802271402180685556e+01,5.336745167198435524e+01,5.545956340581076205e+01
1.006014823864635019e+02,2.306892035727831303e+00,1.000282588115706028e+00,1.002683738440358852e+00,1.080464374953439499e+00,1.518402580837026221e+02,6.063168856078927860e+01,7.337956970217655339e+01,4.025924419586787906e+01,3.347957483711731896e+01,4.945995687631079107e+01,5.482171949253503840e+01,5.150348530430273541e+01,5.175366944712241235e+01,5.694770865728408893e+01,5.633202972517375429e+01
1.005849729945273765e+02,2.305933684436223707e+00,1.000348239052416099e+00,1.002795093077239796e+00,1.083739644360296461e+00,1.515460975014876510e+02,5.974781739799922775e+01,7.061113203158667773e+01,3.556763705111806217e+01,3.987665787550113095e+01,5.586750307242181179e+01,5.574145621311318166e+01,5.218579113533002811e+01,5.672448397299843492e+01,5.819482984271972015e+01,5.718325789824880445e+01
1.005670340675635543e+02,2.304878764026838667e+00,1.000410918641548408e+00,1.002916088279292017e+00,1.087672723412098863e+00,1.514695258452034921e+02,5.779215142742676647e+01,6.104277238872006706e+01,3.360291118691333168e+01,4.631089646352997136e+01,6.119600944280373511e+01,5.685241087074901856e+01,5.470969054467143877e+01,6.157845679233656710e+01,5.917644203877365783e+01,5.802072201192206080e+01
1.005494236941624990e+02,2.303657341122580249e+00,1.000468855375018729e+00,1.003048032617743557e+00,1.092548687518603678e+00,1.526084213106346397e+02,5.505827864903716318e+01,6.105616361021554184e+01,3.332880292861020166e+01,5.326385195932274996e+01,6.239680207696576275e+01,5.800410948190227600e+01,6.040565969000105184e+01,6.373754158952555571e+01,6.019957687059397955e+01,5.608306606255831639e+01
1.005282879150561968e+02,2.302301426627018976e+00,1.000520438508549770e+00,1.003192482707968791e+00,1.098476408327297982e+00,1.515021110455938924e+02,6.234391521886447407e+01,6.008086475423445449e+01,3.845476873958219244e+01,6.107058904377873887e+01,6.352665177611316949e+01,5.912338408232206888e+01,6.663784252325498869e+01,6.484280362086738592e+01,6.117029473633654391e+01,4.600037825460749019e+01
1.005048567748553268e+02,2.300708760156941146e+00,1.000564361961463478e+00,1.003351304903550512e+00,1.104994364929877237e+00,1.396106168875633671e+02,7.828430702673014707e+01,5.002488295216773651e+01,4.761424512256686370e+01,6.965163380100754864e+01,6.499119606733387400e+01,6.438401502376906649e+01,7.044061686384546306e+01,6.609293465463775874e+01,5.680655105231077329e+01,4.650599928772290781e+01
1.004790521156693615e+02,2.299115384705374687e+00,1.000600340420567003e+00,1.003526756367313144e+00,1.110633545084555696e+00,1.185305347754459859e+02,9.471689468491416619e+01,4.324770542716704114e+01,5.696402457649005413e+01,7.247541448903437811e+01,6.636385749857308269e+01,7.218462485601902756e+01,7.173279221060217026e+01,6.728862667590172464e+01,4.807957986736430200e+01,4.797894669274637636e+01
1.004506123065408616e+02,2.297010927716605977e+00,1.000630553964173552e+00,1.003721593011562385e+00,1.115100455832720217e+00,9.944610233466003990e+01,9.368656485799095890e+01,4.124001587946077763e+01,6.715933190185883461e+01,7.389148453774883762e+01,6.919201417905672713e+01,7.852330733669694496e+01,7.328884162153873660e+01,5.975987694047923071e+01,4.903316348654509937e+01,5.038805460446030793e+01
1.004184850321042290e+02,2.294632541160825490e+00,1.000658712960209584e+00,1.003939215303972343e+00,1.124930355794627301e+00,9.206298842676550009e+01,7.920868366181674958e+01,4.526888285037988879e+01,7.954597503783567447e+01,7.591344994898973653e+01,7.841374866527458209e+01,8.028912078481283743e+01,7.492383717635053131e+01,5.291831372036293857e+01,5.115362573786951828e+01,5.347956549113015257e+01
1.003825109872655332e+02,2.291723146362512953e+00,1.000684380371123616e+00,1.004183868398010215e+00,1.149413312621245575e+00,9.023086659679212573e+01,8.206540520111796866e+01,5.919559579245911607e+01,8.650751090155594625e+01,7.762522906860937155e+01,8.814172796454425907e+01,8.227209555041996225e+01,6.215507529406629317e+01,5.461684127994518434e+01,5.445262615678165474e+01,7.091686920145525619e+01
1.003422111986812411e+02,2.288388588703855753e+00,1.000705450888471626e+00,1.004460921763790759e+00,1.152695157323448960e+00,8.483256999008486332e+01,6.625804542391071550e+01,7.396977460054033315e+01,8.837871972415413779e+01,8.538495136447271250e+01,9.123245413658818848e+01,8.465324048820187386e+01,5.903997074365975806e+01,5.790582399151685422e+01,6.549337554365895642e+01,8.065117273006651999e+01
1.003009183136697686e+02,2.284194977133271909e+00,1.000718800865728397e+00,1.004777267773999450e+00,1.105082713772977954e+00,9.408053246255123270e+01,5.584969058467672198e+01,9.089737745981315697e+01,9.131232190170415208e+01,9.923879048191591323e+01,9.380840999339407915e+01,6.550167267445826269e+01,6.186334700586736091e+01,6.202101283941208720e+01,8.405955759834547791e+01,8.685006918017313637e+01
1.002467020818891683e+02,2.279300890177672567e+00,1.000719913165678321e+00,1.005141902783414531e+00,1.117179153188875507e+00,1.291613011451367186e+02,5.609744186941542665e+01,1.070425562905978865e+02,9.470390608605990224e+01,1.057638551850094188e+02,9.616248953198872584e+01,6.722456590942158527e+01,6.673940035518243974e+01,9.036396966818392684e+01,9.113716124543279307e+01,9.439893658384710307e+01
1.001870653124057355e+02,2.272914212269554923e+00,1.000702524476664745e+00,1.005566796228197779e+00,1.185560395430379499e+00,1.396318707068116680e+02,7.843540361058433064e+01,1.100466454440426531e+02,1.120243166077389105e+02,1.091616242396316068e+02,7.499621397944130763e+01,7.203463644344674321e+01,9.149200997282105163e+01,9.843734713405608261e+01,9.983933859229097152e+01,1.077984932814295007e+02
1.001237091370626615e+02,2.265275189275354428e+00,1.000658386232515795e+00,1.006068229280819182e+00,1.194362749370244448e+00,1.194884780689357768e+02,1.028266112767527147e+02,1.122903106810428113e+02,1.237440593646878000e+02,1.065981018482468272e+02,7.838812027505264268e+01,8.207450540703669617e+01,1.048820059420874031e+02,1.064813074260811021e+02,1.131300324943355662e+02,1.277169292096599094e+02
1.000409255639123671e+02,2.254771908017791482e+00,1.000577247611257325e+00,1.006668928285611386e+00,1.229185768220885544e+00,6.871717537247087648e+01,1.071015799442947696e+02,9.651008405184968808e+01,9.970847682689128533e+01,8.641095656715418727e+01,8.531275046056116196e+01,8.693494018290674319e+01,8.798890226751829857e+01,9.478265183113703074e+01,9.352947515322749439e+01,1.117801972785453302e+02
9.993608175009217121e+01,2.243236252151945109e+00,1.000449707744198280e+00,1.007401603867234874e+00,1.386881872544875716e+00,4.375266544028150406e+01,1.100884866584085415e+02,1.195033407946977064e+02,9.959136911559249938e+01,9.222975275900195413e+01,9.463789943613751632e+01,9.579351289379842171e+01,1.036852549271710018e+02,9.792712478476437354e+01,9.812210439967515185e+01,1.172484024110927407e+02
9.982310024701803286e+01,2.224570433538070269e+00,1.000270383879543701e+00,1.008283838732699111e+00,1.882909246172762785e+00,7.026465615113977492e+01,1.093932218418544977e+02,1.199991970253799707e+02,1.027169782348449445e+02,1.042605526776778504e+02,1.056560548856604242e+02,1.099348867023714718e+02,1.081157081980723547e+02,1.060828616629729311e+02,1.041293970731480556e+02,1.200485752014330814e+02
9.968418085380163518e+01,2.199996485666712243e+00,1.000046217318053765e+00,1.000014197485607381e+00,1.002562858031148973e+00,1.242570592887669534e+02,1.424179937322481067e+02,1.204986269653855828e+02,1.169564413970101100e+02,1.184618159091829881e+02,1.198435114109064870e+02,1.198099698410953096e+02,1.189596551705495102e+02,1.114765670877850710e+02,1.073386914247755897e+02,1.234996036108719153e+02
9.950630557082004657e+01,2.164239463219126414e+00,1.000181920741406882e+00,1.000000000000030642e+00,1.036151706931111027e+00,1.505257969452060820e+02,1.519168367277767118e+02,1.320932073013161130e+02,1.349695484525008737e+02,1.372424455639730070e+02,1.371700636057246925e+02,1.347793715988259180e+02,1.235848876853136176e+02,1.157938085245286288e+02,1.089696771643386342e+02,1.227908969988889538e+02
9.927515959294301240e+01,2.107832465592954563e+00,1.000309369904327506e+00,1.000000000000000000e+00,1.031501072631058724e+00,1.604699610120972011e+02,1.530673787148907081e+02,1.529745578913584723e+02,1.542767436999340589e+02,1.562256779639750732e+02,1.482034841832842460e+02,1.328127074643798267e+02,1.190119068163035934e+02,1.082516343478364007e+02,9.951330347151326805e+01,7.288052230471616610e+01
9.896666610388039942e+01,2.012533447478488391e+00,1.000233135611705793e+00,1.000000000000000000e+00,1.066823754857996409e+00,1.488472440853240641e+02,1.217701714433882501e+02,1.236742565464350037e+02,1.267002736756588490e+02,1.058780177802163962e+02,8.347589801425348810e+01,6.575645335410079895e+01,5.237817923967809719e+01,4.179919509352382079e+01,3.306351540759070673e+01,2.588078082503154320e+01
9.847126954193242909e+01,1.873103500049638992e+00,1.000050369470387279e+00,1.000000000000000000e+00,1.006742517461443054e+00,1.582532186718763114e+02,1.635697902054401993e+02,1.623887353718762085e+02,1.199394796949329560e+02,8.702331941416342431e+01,6.424427152697836618e+01,4.726210231223819136e+01,3.408402027868240936e+01,2.355856680000423609e+01,1.404372555799837485e+01,6.412541304132147069e+00
1.350812891915495300e+02,1.728572706879480947e+00,1.000103140918580102e+00,1.000000000000000000e+00,1.503807900539122056e+00,2.423366756041291978e+02,2.078273130093005534e+02,1.290147533200080545e+02,8.182680773921693174e+01,5.036345883995913653e+01,2.738362848245026271e+01,9.084652336127007288e+00,1.202502164282544195e+00,2.264685934698971170e+00,1.432618710561299746e+00,1.174871020538722721e+00
2.079560301465934344e+02,1.582524934729494817e+02,1.022879020129050520e+00,1.000000000000000000e+00,1.641428975479099392e+02,2.511798734390672223e+02,9.808508491557356024e+01,1.696502482098399156e+01,3.506390850336464027e+00,1.346380456103783985e+00,1.503356754682348528e+00,1.036978609452650968e+00,1.186855323372084658e+00,1.212513671436629359e+00,1.164698889143131799e+00,1.105536161332527634e+00
1.000000000000000000e+00,1.000000000000000000e+00,1.000000000000000000e+00,1.000000000000000000e+00,1.000000000000000000e+00,1.000000000000000222e+00,1.000000000000000000e+00,1.000000000000000000e+00,1.000000000000000000e+00,1.000000000000000000e+00,1.000000000000000000e+00,1.000000000000000000e+00,1.000000000000000000e+00,1.000000000000000000e+00,1.000000000000000000e+00,1.000000000000000000e+00
1.000014811058688613e+00,1.000000966160788707e+00,1.000000214805789378e+00,1.000000000000000000e+00,1.000011351052285891e+00,1.000194902614336412e+00,1.000839609999878643e+00,1.000008390351336374e+00,1.002325544995050999e+00,1.003298934290453692e+00,1.003343700694426133e+00,1.003090974287597748e+00,1.002445434934810642e+00,1.001309222041346203e+00,1.000266400421840007e+00,1.002075860433073506e+00
