Room No. 1 , Exit F, 
 dX[m], dY[m] , minX[m] , maxX[m], minY[m], maxY[m] 
   1.000000  ,  1.000000    ,  -5.000000  ,  11.000000  ,  -11.000000 ,  37.000000
1.017422479802148843e+02,1.686944079830435594e+00,1.156667259461806152e+00,1.159752088234555556e+00,1.212783346584247024e+00,1.271101719628250635e+02,1.073196690166381586e+02,8.274039925167805620e+01,5.011721492770317354e+01,3.726120095478253802e+01,4.407851160703751248e+01,3.889712534077046513e+01,3.297862255056213598e+01,2.598507360882280892e+01,2.724367548644692150e+01,3.227643586155213029e+01
1.013580701234152457e+02,2.517362666300076768e+00,1.160166768655027436e+00,1.163294228460156621e+00,1.226039518843149878e+00,1.287383782817689450e+02,1.076234734504526500e+02,8.315886338940988765e+01,4.767191023872755551e+01,3.663118459780248770e+01,4.739889775744953937e+01,3.837651964879083266e+01,3.126923268453224125e+01,2.610278044474289771e+01,2.925561286814161122e+01,3.422748785974700780e+01
1.006740045035880087e+02,1.477560882642527051e+00,1.163828988310029899e+00,1.166997007520281571e+00,1.229700408681337009e+00,1.292866220082073880e+02,1.079707937118992191e+02,8.371048676500009833e+01,4.608133754790870285e+01,3.627808228385750056e+01,5.019919963992682455e+01,3.925290865650882921e+01,2.995673122056193094e+01,2.646155349577425042e+01,3.124895658524484077e+01,3.623313037725466046e+01
1.009400186580635790e+02,1.503348314732958269e+00,1.167663101991498253e+00,1.170871606536862730e+00,1.234342623890923196e+00,1.293893019904367634e+02,1.080978408336326027e+02,8.407394228644290024e+01,4.539591154559895614e+01,3.732272232594436900e+01,5.110853966264687642e+01,4.003680229465214069e+01,2.911284719710392466e+01,2.749955191813030098e+01,3.328570917604027812e+01,3.832151427560875590e+01
1.009746308040936782e+02,1.249193685350541649e+00,1.171682345071834552e+00,1.174930268942173228e+00,1.240676510464649995e+00,1.287517955688741722e+02,1.082236763718443200e+02,8.361298590543648857e+01,4.530451125711913107e+01,4.032984255470481116e+01,4.940244893248753755e+01,3.929638502689459045e+01,2.876655332776589802e+01,2.943853332280987090e+01,3.549325140559656688e+01,4.062346791552277381e+01
1.009374007282354029e+02,2.135430611405440438e+00,1.175903220520783998e+00,1.179186429709255357e+00,1.249355274215277145e+00,1.279182218106426632e+02,1.084383927643314962e+02,8.171387865044485466e+01,4.533340606139832829e+01,4.447800591183407448e+01,4.623192460194785269e+01,3.722285357013094398e+01,2.879524992213833556e+01,3.185188961747465086e+01,3.783272714520786906e+01,4.313643941851225350e+01
1.009360415263874700e+02,2.130631203415873198e+00,1.180341168717210731e+00,1.183654863917779076e+00,1.260025873704984312e+00,1.272277176872576376e+02,1.086778776886921634e+02,7.817534082287397723e+01,4.522082687151043245e+01,4.874647545731895093e+01,4.392516338232957906e+01,3.504357363032917050e+01,2.904582513356384865e+01,3.426653915192194688e+01,4.024002646320727905e+01,4.540981226446232455e+01
1.009346334341047822e+02,2.125574952777015802e+00,1.185011963183386863e+00,1.188351858116730497e+00,1.270557648323985989e+00,1.264497011879544601e+02,1.089257518029612868e+02,7.341786116603181256e+01,4.490569898391696313e+01,5.317700267075773013e+01,4.400452635718205130e+01,3.341883605230003695e+01,2.994120283992793219e+01,3.673976187342547917e+01,4.280941746285901672e+01,4.683235492234052799e+01
1.009331763460845224e+02,2.120240356107488289e+00,1.189934285007799630e+00,1.193295408672124136e+00,1.276979371248101236e+00,1.256030769907877698e+02,1.091727429265061886e+02,6.820242344732903916e+01,4.421053503174312738e+01,5.745152319693669796e+01,4.536467498274951282e+01,3.246825896291007041e+01,3.203914142057105607e+01,3.944036940037243966e+01,4.570169269444897964e+01,4.753514251515425570e+01
1.009316709293738228e+02,2.114610566481236020e+00,1.195128919102474985e+00,1.198505452190967713e+00,1.273731023891805370e+00,1.259245244705156210e+02,1.093639997006341105e+02,6.325916313788868450e+01,4.336542847752293994e+01,5.947066241416477794e+01,4.520132395321530083e+01,3.220600892971479823e+01,3.496790734091194963e+01,4.229223960073399979e+01,4.861754499444732147e+01,4.824904608202301404e+01
1.009301189806537309e+02,2.108651928700465028e+00,1.200619009486891153e+00,1.204004134240889368e+00,1.258098810359084663e+00,1.284283665046352212e+02,1.094944147517179402e+02,5.930772575867811724e+01,4.412741778407053772e+01,5.744720191040763524e+01,4.275913126204284254e+01,3.236144578298782903e+01,3.795282196804664920e+01,4.525005249198093082e+01,5.067027234533451718e+01,4.915833119764540271e+01
1.009285238103864231e+02,2.102343282458683404e+00,1.206430394002846906e+00,1.209816124002287996e+00,1.240271700848187830e+00,1.246305801418325672e+02,1.011450144467955994e+02,4.845802006874419732e+01,3.962531405541997032e+01,4.460643504313271990e+01,3.134374481563295944e+01,2.448117586549193447e+01,3.246813148875992283e+01,3.997365124687605231e+01,4.308045337363942906e+01,4.344519988256154619e+01
1.009268906575216675e+02,2.095642152580337481e+00,1.212592003038658106e+00,1.215968984281350362e+00,1.248601866517613734e+00,1.359626909909634094e+02,1.014514513939393083e+02,4.755572994171254209e+01,4.538027507879723288e+01,4.197712180513254054e+01,2.903450030343957167e+01,2.639190018456025300e+01,3.559604874041649225e+01,4.333767041617344518e+01,4.364986197345597674e+01,4.418508815182948268e+01
1.009252271510811312e+02,2.088521254675117955e+00,1.219136261194515347e+00,1.222493608590892400e+00,1.285621251633102702e+00,1.483906166452539139e+02,1.021339108682062005e+02,4.732007819923123293e+01,5.128292961632282498e+01,4.290181184007094117e+01,2.772703251093484766e+01,2.971116857012289714e+01,3.887873584733447530e+01,4.602665507356498864e+01,4.447447633593361616e+01,4.488113901746100964e+01
1.009235430208290438e+02,2.080926045466825691e+00,1.226099614767743873e+00,1.229424739923332899e+00,1.312672843455722216e+00,1.522548344020345894e+02,1.022985642916931113e+02,4.689555899436916064e+01,5.745032667455922848e+01,4.360094879911014942e+01,2.734335296022555184e+01,3.321097050896820946e+01,4.235867582686280031e+01,4.717451945231171351e+01,4.531183796181272072e+01,4.546867599766946455e+01
1.009218513953435092e+02,2.072820638038754382e+00,1.233523148979318584e+00,1.236801589601702389e+00,1.323053617645923552e+00,1.522713574556421463e+02,9.997348837877441952e+01,4.603974873314695060e+01,6.135875373439074565e+01,4.062460087417665733e+01,2.747777947104407659e+01,3.681537245006788339e+01,4.636682699607722213e+01,4.782361830265282521e+01,4.619619080020893875e+01,4.687257135543762132e+01
1.009201721966222181e+02,2.064133499813809447e+00,1.241453308148672052e+00,1.244668579480738169e+00,1.334422848962717012e+00,1.522830913381058622e+02,9.384821307696347503e+01,4.442086366472685910e+01,5.873270748534299912e+01,3.638677169829811220e+01,2.917217318102581558e+01,4.081970732237309107e+01,5.019775892200248535e+01,4.880828658605700099e+01,4.697236330864136278e+01,4.990478276775019140e+01
1.009185427387852201e+02,2.054815822162547434e+00,1.249942739600369057e+00,1.253076237167326745e+00,1.346944943805342909e+00,1.522888474261157512e+02,8.486548859629712638e+01,4.397080535107742350e+01,5.233225196757798869e+01,3.335231915771931455e+01,3.321920695569266258e+01,4.501920481526335749e+01,5.211958053165267302e+01,4.982163569873242892e+01,4.781118663811179914e+01,5.362611518322333382e+01
1.009170201415104202e+02,2.044770848114525919e+00,1.259051281593040361e+00,1.262082282375432962e+00,1.360822603850711410e+00,1.523041787851100537e+02,7.536205550413501442e+01,4.924803250287505563e+01,5.019594778061510709e+01,3.192429992050830379e+01,3.779656006059212103e+01,4.968966854675284850e+01,5.291018458382760770e+01,5.089415081777774930e+01,5.028910343408234240e+01,5.746737610766430748e+01
1.009156487683593895e+02,2.033929751771439420e+00,1.268847115458551666e+00,1.271752953781114748e+00,1.376310449216969989e+00,1.523688540537449967e+02,6.760118426895512300e+01,5.827389605335037714e+01,5.220285967576515418e+01,3.170672788312230495e+01,4.254155688553922232e+01,5.487678359528130301e+01,5.410142492638891554e+01,5.176686474073341770e+01,5.446685783932661451e+01,6.022029735111280502e+01
1.009145960373733857e+02,2.022158158720774868e+00,1.279408108580547321e+00,1.282164640872627492e+00,1.393744615416285804e+00,1.524934595280316501e+02,6.361525434015042890e+01,6.767171916147293587e+01,4.951054208873024720e+01,3.286222052797130289e+01,4.783907608197951333e+01,5.816778013022934601e+01,5.535520435633215186e+01,5.325803186583578253e+01,5.901136968658929760e+01,6.116046480689612252e+01
1.009157089435916959e+02,2.009355471594280296e+00,1.290823709537189723e+00,1.293405905844158932e+00,1.413570872934110323e+00,1.525532606386644261e+02,6.279481591627370562e+01,7.579590567235641174e+01,4.343587145987533660e+01,3.767568704801629309e+01,5.345631285262668086e+01,5.924550365667318630e+01,5.666407508361359646e+01,5.738440919095745585e+01,6.294037630161893304e+01,6.218107223455537280e+01
1.009239843800988723e+02,1.995327609407173242e+00,1.303198534664853137e+00,1.305580008809677839e+00,1.436356895950988033e+00,1.523714414700576469e+02,6.212994533597997560e+01,7.310613158626516395e+01,3.929445069982408256e+01,4.390449108279567980e+01,6.004681073684938042e+01,6.071258329208477278e+01,5.772299121678112499e+01,6.276294185572407258e+01,6.439162841634194479e+01,6.336991665794961648e+01
1.009449028967896567e+02,1.979919445195293726e+00,1.316657315131260386e+00,1.318808088837450931e+00,1.462895989789311457e+00,1.524415639803782483e+02,6.037789362639558277e+01,6.364358991454987091e+01,3.787611416698133127e+01,5.043193438768249592e+01,6.560725179470975377e+01,6.230434080179606582e+01,6.072350389779309410e+01,6.806512776866583181e+01,6.553283344392059462e+01,6.475709463474235861e+01
1.009824123138309488e+02,1.962837573410994407e+00,1.331348698861031687e+00,1.333233208500493427e+00,1.494199239171847049e+00,1.537722802477975108e+02,5.782209580853798769e+01,6.375853214232052579e+01,3.823388935387269782e+01,5.773478641851348669e+01,6.735915746530115200e+01,6.390658116296945934e+01,6.689942840685833403e+01,7.052106322135043115e+01,6.694634980785002654e+01,6.346368013368746119e+01
1.010261765524116839e+02,1.943836410553398508e+00,1.347450710190725820e+00,1.349025548371208139e+00,1.531244688701145495e+00,1.529149510119470108e+02,6.525520618486926594e+01,6.319365169246825076e+01,4.352476338958550883e+01,6.584383857121433437e+01,6.920474823685069055e+01,6.553904993991061190e+01,7.368435196255055075e+01,7.180541657882571371e+01,6.860440584656382157e+01,5.443924519066740686e+01
1.010819399820009323e+02,1.922461291976228726e+00,1.365178716049311181e+00,1.366389151867343887e+00,1.574659212068096448e+00,1.413383023442174817e+02,8.133039779604166597e+01,5.399173781517166049e+01,5.244373445364333719e+01,7.467743270980722059e+01,7.129347084111635979e+01,7.141577594607234403e+01,7.792329409108195648e+01,7.351135994484147318e+01,6.498223361516409113e+01,5.545189769043822281e+01
1.011937167487452456e+02,1.898435655661782073e+00,1.384796599538202111e+00,1.385570788529978836e+00,1.624507497812204271e+00,1.206440004620491635e+02,9.790118471517020282e+01,4.806587580416330496e+01,6.197528373435153526e+01,7.812535937942611497e+01,7.325623695705291993e+01,7.986871872999822131e+01,7.943362563729212411e+01,7.558486024330163389e+01,5.754596914676641006e+01,5.760063241349666896e+01
1.014619993951712473e+02,1.870594920218780821e+00,1.406630844395302393e+00,1.406871754839559729e+00,1.683071240555865877e+00,1.020145800801046647e+02,9.700862924769521101e+01,4.697651960156959206e+01,7.268323885911956950e+01,8.051087385280449382e+01,7.682407591047655160e+01,8.684372676321036977e+01,8.152744220650066609e+01,6.898750358413860795e+01,5.878974176114636663e+01,6.050740863283854054e+01
1.018000931890729817e+02,1.837444507328405807e+00,1.431088111305783617e+00,1.430663814781539811e+00,1.760802284120926764e+00,9.513274981559382582e+01,8.271500671970368046e+01,5.163754584259895353e+01,8.543568612737962553e+01,8.337568554201740767e+01,8.684679683160547370e+01,8.890948116470566731e+01,8.429982870721717347e+01,6.357958072865145027e+01,6.220948786864413904e+01,6.321339047798828403e+01
1.019181914848891495e+02,1.784258898395274962e+00,1.458684759363279237e+00,1.457411079567366929e+00,1.872903508772853165e+00,9.379666059091236718e+01,8.593733387462157225e+01,6.522487468437907410e+01,9.307216985658698150e+01,8.591448376289866928e+01,9.747174381119782538e+01,9.153468689109071477e+01,7.283537792684283829e+01,6.578251254879293697e+01,6.527025034061007602e+01,8.021410337941411228e+01
1.020981532987419769e+02,1.684372532214317486e+00,1.490089510115846894e+00,1.487700578923749628e+00,1.993245657168152052e+00,8.884155896389997054e+01,7.153839678576802896e+01,8.038148702413529634e+01,9.631365716837653679e+01,9.474591230181940205e+01,1.010315756591001133e+02,9.538670516287970713e+01,7.095004245711390922e+01,7.003768333467694163e+01,7.582553879834919996e+01,9.006291316725985041e+01
1.022261200039431941e+02,1.539144227278972821e+00,1.526192493035045672e+00,1.522285837419749654e+00,2.108525316955923934e+00,9.843704568360996632e+01,6.263202726834524725e+01,9.804062013187665059e+01,1.004471450698954413e+02,1.097852656169147139e+02,1.043857531173437820e+02,7.813376541725604341e+01,7.525411975491419980e+01,7.360988371142249775e+01,9.411166052516632874e+01,9.665996284283188800e+01
1.022322127844261956e+02,1.331680285920920914e+00,1.568218454880540236e+00,1.562150402328071674e+00,2.364810952609874839e+00,1.338212828012057969e+02,6.448252807868186665e+01,1.149147635106062211e+02,1.051369778125553864e+02,1.171255688586629873e+02,1.085941874658654172e+02,8.070216902769985268e+01,7.988201014180343407e+01,1.011606418388401352e+02,1.018073189142756405e+02,1.049169098380092606e+02
1.021860304488321844e+02,1.234500223918004069e+00,1.617910427978475507e+00,1.608602859913208727e+00,2.829341686945828549e+00,1.445963170617150979e+02,8.645801120336881240e+01,1.199493464136980947e+02,1.240544035122844235e+02,1.214887440172195596e+02,9.002666277605844414e+01,8.717808295586718259e+01,1.038677278010054721e+02,1.101320110782032202e+02,1.111551469073355065e+02,1.154849031230013026e+02
1.020686048479842754e+02,1.812355192452192121e+00,1.677864222947562656e+00,1.663423186974083867e+00,3.511451656119158660e+00,1.248193533539545967e+02,1.117290729516750787e+02,1.240445535920999873e+02,1.372540083344028687e+02,1.205947460051980329e+02,9.365750288951440439e+01,9.629737750253474360e+01,1.178210113317331462e+02,1.186700110746595271e+02,1.215106929843496459e+02,1.427761242646619166e+02
1.020471345790294748e+02,2.214089288901718078e+00,1.752138040421813869e+00,1.729095993615604065e+00,4.667193892505767217e+00,7.539287255407296584e+01,1.157978025754015050e+02,1.095678404462387761e+02,1.134409248562309216e+02,1.011649778798351349e+02,9.933044600636344512e+01,9.932558420425259271e+01,1.004724180751520350e+02,1.028971357641427886e+02,1.104303282587629411e+02,1.260205892237463985e+02
1.023499585891615595e+02,2.460805628008531531e+00,1.847425529085330975e+00,1.809197444493540363e+00,6.494978346161415672e+00,5.124464294052771862e+01,1.193221383334960137e+02,1.321341443675457015e+02,1.125604242213222506e+02,1.061869747299662237e+02,1.063359590202645819e+02,1.072382278458901510e+02,1.084831759903704409e+02,1.133787654711107393e+02,1.125476119850860641e+02,1.300992478550133171e+02
1.020887724996821788e+02,2.589791790072765387e+00,1.975379077946576967e+00,1.909040094651512032e+00,7.095221218111259276e+00,7.614289775792397563e+01,1.190427946436805655e+02,1.307337719631063635e+02,1.146286809998409950e+02,1.150622998936234325e+02,1.158869788161604077e+02,1.157800853590718191e+02,1.223593859514192701e+02,1.169405301122845486e+02,1.168113205221119699e+02,1.292935184911777640e+02
1.014196978854897822e+02,2.299609040442440744e+00,2.156024108668763262e+00,1.992513775390127861e+00,2.036292059134220622e+00,1.276498770208253575e+02,1.514017595744344362e+02,1.285842353588486162e+02,1.249068880750340753e+02,1.262141428483510452e+02,1.264179157594670500e+02,1.270798806954833680e+02,1.272351623902254545e+02,1.201829135399646589e+02,1.170681729055668825e+02,1.314860810981566033e+02
1.014345888290373523e+02,3.185876709075804669e+00,2.420177124128570334e+00,2.155102343675251220e+00,1.893030370379024330e+00,1.518541266026499557e+02,1.578418724509033382e+02,1.369673327443551614e+02,1.400564544270016256e+02,1.410592164154802788e+02,1.417827615732045388e+02,1.409249372265895204e+02,1.289863257427973053e+02,1.215452652257069417e+02,1.164442179650934008e+02,1.262450771800639018e+02
1.012066844052597361e+02,2.462751638401349030e+00,2.796983564211064976e+00,2.381423965448078661e+00,2.022037718304530163e+00,1.615721165502490919e+02,1.538176067100582145e+02,1.539907191270999647e+02,1.552708419189045514e+02,1.567646905230735399e+02,1.487119056126698524e+02,1.331093837700182121e+02,1.195063034940246069e+02,1.085521031234387976e+02,9.987621050423149427e+01,7.288146100264532379e+01
1.001792744272008946e+02,2.732999038756234178e+00,3.249191040315541290e+00,2.717969410497208749e+00,2.212876209737009159e+00,1.495667143649641844e+02,1.225710950757300708e+02,1.245480228852588596e+02,1.269716014456942901e+02,1.058913635012035854e+02,8.347663260460427637e+01,6.575621079561027216e+01,5.237816259524195317e+01,4.179926633383409040e+01,3.306349553593346968e+01,2.588075865562644751e+01
9.927182658486648847e+01,2.462265544093098057e+00,3.557033108305457603e+00,3.271045652621448419e+00,2.402606153596628324e+00,1.591490730920966996e+02,1.647280966140637020e+02,1.625871982246983123e+02,1.199351702523677545e+02,8.702299681935926401e+01,6.424438391427392503e+01,4.726210200602864120e+01,3.408399073536796919e+01,2.355857160241846771e+01,1.404373603425652206e+01,6.412545119734850196e+00
1.359042736661937170e+02,1.456975859035699372e+00,2.699722179128043464e+00,4.331846914868144438e+00,2.909564353502386513e+00,2.440524813098455468e+02,2.078541175543109318e+02,1.290142432624167554e+02,8.182695069696822543e+01,5.036341475945647517e+01,2.738364453144230737e+01,9.084658034267908633e+00,1.202506051774975715e+00,2.264690068804141809e+00,1.432620458128037289e+00,1.174871208060149108e+00
2.079543529870495888e+02,1.584776749731088898e+02,1.099649120504726740e+00,1.970167541207271888e+00,1.643548332255784317e+02,2.511789305665288339e+02,9.808499955504622392e+01,1.696503606737553582e+01,3.506399043874049326e+00,1.346380826811218068e+00,1.503359794965864804e+00,1.036981064602145564e+00,1.186853937551234583e+00,1.212513134597082542e+00,1.164698909585538233e+00,1.105536511211218542e+00
1.000000000000011768e+00,1.000000000000017319e+00,1.000000000000027534e+00,1.000000000000000000e+00,1.000000000000003553e+00,1.000000000000001776e+00,1.000000000000001110e+00,1.000000000000000888e+00,1.000000000000000666e+00,1.000000000000000666e+00,1.000000000000000444e+00,1.000000000000000444e+00,1.000000000000000444e+00,1.000000000000000444e+00,1.000000000000000444e+00,1.000000000000000222e+00
1.000014899000941648e+00,1.000000878021385153e+00,1.000000213605502841e+00,1.000000007840224470e+00,1.000011336112879956e+00,1.000194907274041034e+00,1.000839621998446560e+00,1.000008422832259214e+00,1.002325502983081318e+00,1.003298882812766912e+00,1.003343651631012579e+00,1.003090944255760508e+00,1.002445434138697244e+00,1.001309252625810498e+00,1.000266341020663807e+00,1.002075776810900098e+00
